# Network Type:               VirtualPartialOrderNetwork
# Morphemic Analysis:         SUFFIX
# Allow Empty Stems:          false
# Corpus File:                /home/radcliff/projects/thesis/paramor_rk/../resources/cz10/dev37kwPlain.txt
# Language:                   GENERIC
# Encoding:                   utf8
# Skipping:                   1st Token
# Reading:                    50000 Types
# Throw Out Numbers:          true
# Case Sensitive:             false
# Skip Type if Length <= :    3
# Ignore SGML tags:           false

# Completed Search Steps in this SearchBatch
# -------------------------------------------

# (1) # Bottom-Up Search# 
# -----------------------------------------------
# Starting From:                ALL_LEVEL_1
# Vertical Metric:              Ratio
# Bottom Max:                   NONE
# Exhaustive Search at Level 1: false
# Use Covered:                  false
# Select Which?:                TERMINAL_ONLY
# Require |Stems| > |Affixes|:  true
# Vertical Metric Cutoffs:      [0.25]
# Top Cutoffs:                  [0]
# Bottom Cutoffs:               [3]
# Max Level Cutoffs:            [null]
# 

# (2) # Calculate Similarity As:                 COSINE
# Cluster with Respect to:                 AFFIX_STEM_PAIRS
# Filter at Cluster Time:                  false
# Discriminative Clustering:               false
# Network Based Discriminative Clustering: true
#   - level 2 Scheme must have >=N Stems:  1
# Affixes in Common Required:              false
# Affixes in Common Forbidden:             false
# At least one child must cover >N Types:  [20]
# Use Merge Credits:                       true
#   - # of Positive Merge Credits          1
# Tie in Type Covered Filtering            true# 

# (3) # Morpheme Boundary Too Far Left Filter# 
# -----------------------------------------------
# Left-Looking Metric:         ENTROPY
# Left-Looking Metric Cutoffs: [0.5]
# 

# (4) # Morpheme Boundary Too Far Right Filter# 
# -----------------------------------------------
# MBTF Right: Left-Looking Metric:         ENTROPY
# MBTF Right: Left-Looking Metric Cutoffs: [0.5]


abel	abel
absenci	absenci
absolvent	absolvent
absolventi	absolventi
absolventů	absolventů
absolvovali	absolvovali
absolvovat	absolvovat
adami	adami
adaptabilní	adaptabilní
administrativa	administrativ +a
administrativních	administrativních
administrativními	administrativními
administrativu	administrativu
administrativy	administrativ +y
administrativě	administrativě
adres	adres
adrese	adrese
adresou	adresou
adresován	adresován
adresu	adresu
adresy	adresy
adresátovi	adresátovi
adresátů	adresátů
adresář	adresář
adresářem	adresářem
adresáři	adresáři
adresářů	adresářů
advertising	advertising
advokátní	advokátní
aero	aero
aeskulap	aeskulap
affaires	affaires
afis	afis
afér	afér
aféry	aféry
agenda	agenda
agentura	agentur +a
agentury	agentur +y
agentuře	agentuře
agentů	agentů
agregátní	agregátní
agregátů	agregátů
agresivity	agresivity
agresivněji	agresivněji
agresivnější	agresivnější
akademie	akademie
akademii	akademii
akce	akce
akceptoval	akceptoval
akceptování	akceptování
akci	akci
akcie	akcie
akciemi	akciemi
akcionář	akcionář
akcionáře	akcionáře
akcionáři	akcionáři
akcionářů	akcionářů
akciová	akciová
akciových	akciových
akcií	akcií
akciích	akciích
akcí	akcí
akcích	akcích
aktivit	aktivit
aktivitami	aktivitami
aktivity	aktivity
aktivitách	aktivitách
aktivní	aktivní
aktualizovány	aktualizovány
aktualizuje	aktualizuje
aktuální	aktuální
akvizičních	akvizičních
alan	alan
alespoň	alespoň
aleš	aleš
alfa	alfa
alternativních	alternativních
alternativy	alternativy
ambasád	ambasád
ambasády	ambasády
americko	americko
americku	americku
americká	americká
americké	americké
americký	americký
amerických	amerických
ameriky	ameriky
američtí	američtí
analyzovali	analyzovali
analyzovat	analyzovat
analyzuje	analyzuje
analyzátory	analyzátory
analýza	analýz +a
analýze	analýze
analýzy	analýz +y
anděl	anděl
andělů	andělů
anebo	anebo
angličtiny	angličtiny
angličtině	angličtině
aniž	aniž
anomáliemi	anomáliemi
anomálii	anomálii
anonymní	anonymní
antala	antala
antického	antického
antikva	antikv +a
antikvy	antikv +y
antonín	antonín
antonína	antonína
anuluje	anuluje
apartmánech	apartmánech
apartmány	apartmány
apartmánů	apartmánů
apartmánům	apartmánům
aplikací	aplikací
aplikovat	aplikovat
apod	apod
apple	apple
aprílové	aprílové
aprílový	aprílový
architektovi	architektovi
architekturu	architekturu
architektů	architektů
architektům	architektům
areál	areál
areálu	areálu
argaláš	argaláš
argentinský	argentinský
argument	argument
argumentem	argumentem
armabeton	armabeton
arnau	arnau
arxon	arxon
arxonu	arxonu
asistent	asistent
asistenty	asistenty
asistentů	asistentů
asociace	asociace
asociací	asociací
asociační	asociační
aspekt	aspekt
aspoň	aspoň
astronomické	astronomické
asymetrie	asymetrie
atmosféře	atmosféře
atrakcí	atrakcí
atraktivní	atraktivní
atraktivním	atraktivním
atriu	atriu
atrium	atrium
augusty	augusty
aukci	aukci
aukcí	aukcí
aukcích	aukcích
aukční	aukční
auta	auta
autem	autem
auto	auto
autobus	autobus
autobusem	autobusem
autobusy	autobusy
autocvičiště	autocvičiště
automechanici	automechanici
automechanik	automechanik
automobilek	automobilek
automobilka	automobil +k +a
automobilky	automobil +k +y
automobilkách	automobilkách
automobilu	automobilu
automobilů	automobilů
autoopravárenství	autoopravárenství
autoopravář	autoopravář
autoopraváři	autoopraváři
autor	autor
autora	autor +a
autorizovaným	autorizovaným
autorovi	autorovi
autory	autor +y
autorů	autorů
autoškoly	autoškoly
auvi	auvi
averzi	averzi
avizovanou	avizovanou
avšak	avšak
axiom	axiom
ačkoli	ačkoli
badatel	badatel
bagr	bagr
bakalářském	bakalářském
balení	balení
balneoprovozů	balneoprovozů
balíku	balíku
balíky	balíky
balíčky	balíčky
bance	ban +ce
band	band
bank	bank
banka	ban +k +a
bankou	ban +kou
bankovkách	bankovkách
bankovnictví	bankovnictví
bankovní	bankovní
bankovním	bankovním
bankrot	bankrot
bankrotem	bankrotem
banky	ban +k +y
bankách	bankách
bankéř	bankéř
barev	barev
barevná	barevná
barevný	barevný
barevným	barevným
barevnými	barevnými
bariér	bariér
bariéry	bariéry
barva	barv +a
barvu	barvu
barvy	barv +y
bary	bary
barů	barů
baterie	baterie
bauma	bauma
bavlna	bavln +a
bavlny	bavln +y
bavlněných	bavlněných
bavorská	bavorská
bazarové	bazarové
bazén	bazén
bazénem	bazénem
bazénu	bazénu
bazény	bazény
bedny	bedny
bedřicha	bedřicha
belgií	belgií
bell	bell
bella	bella
beranových	beranových
berlínských	berlínských
berou	berou
beroun	beroun
bertelsmann	bertelsmann
beru	beru
beseduje	beseduje
beso	beso
beta	bet +a
betakarotenu	betakarotenu
betlémské	betlémské
betonovými	betonovými
betonu	betonu
betonářského	betonářského
bety	bet +y
betě	betě
bezbřehý	bezbřehý
bezdrátové	bezdrátové
bezesporu	bezesporu
bezmocně	bezmocně
bezpečnost	bezpečnost
bezpečnosti	bezpečnosti
bezpečnostní	bezpečnostní
bezplatnou	bezplatnou
bezplatné	bezplatné
bezplatnému	bezplatnému
bezpochyby	bezpochyby
bezpodílového	bezpodílového
bezpodílovém	bezpodílovém
bezpodílovými	bezpodílovými
bezprostřední	bezprostřední
bezradnosti	bezradnosti
beztrestné	beztrestné
bezvaječné	bezvaječné
bilance	bilance
biohrnce	biohrnce
biohrnec	biohrnec
bitez	bitez
bití	bití
bižuterie	bižuterie
blahobytně	blahobytně
blahopřejeme	blahopřejeme
blažíčkové	blažíčkové
bližší	bližší
bloků	bloků
blovice	blovice
blábolivé	blábolivé
blázen	blázen
blízko	blízko
blízkosti	blízkosti
blízké	blízké
blíží	blíží
bobek	bobek
bodovat	bodovat
bodrum	bodrum
bodrumu	bodrumu
bodu	bodu
bodují	bodují
body	body
bodů	bodů
bohatou	bohatou
bohatství	bohatství
bohaté	bohaté
bohdaneč	bohdaneč
bohulibé	bohulibé
bohuslav	bohuslav
bohužel	bohužel
bojovat	bojovat
bojuje	bojuje
bojují	bojují
bojí	bojí
boku	boku
bolení	bolení
bombardier	bombardier
bombastické	bombastické
bond	bond
bonity	bonity
boom	boom
bory	bory
bota	bot +a
boty	bot +y
boukal	boukal
bočním	bočním
bral	bral
brandy	brandy
brandýs	brandýs
branná	branná
branné	branné
branži	branži
britské	britské
britského	britského
britských	britských
británie	británie
británii	británii
britští	britští
brno	brno
brněnka	brněnka
brněnské	brněnské
brouzdaliště	brouzdaliště
brouzdalištěm	brouzdalištěm
broušení	broušení
brožury	brožury
brožík	brožík
bruntálsku	bruntálsku
bruselem	bruselem
brzda	brzda
brzdit	brzdit
brzdící	brzdící
brzy	brzy
bránit	bránit
brání	brání
brát	brát
bubeneč	bubeneč
bubeníček	bubeníček
bubák	bubák
bude	bude
budeme	budeme
budete	budete
budiž	budiž
budou	budou
budoucna	budoucna
budoucnost	budoucnost
budoucnosti	budoucnosti
budoucnu	budoucnu
budoucí	budoucí
budoucím	budoucím
budova	budova
budovu	budovu
budovách	budovách
budu	budu
bulletin	bulletin
burgiba	burgib +a
burgiby	burgib +y
burnaston	burnaston
burnastonu	burnastonu
burza	burz +a
burze	burze
burzovnictví	burzovnictví
burzovních	burzovních
burzy	burz +y
burzách	burzách
burzám	burzám
buďte	buďte
buďto	buďto
bych	bych
bychom	bychom
bydlení	bydlení
bydliště	bydliště
bydlí	bydlí
bydlíme	bydlíme
byla	byl +a
byli	byli
bylo	bylo
byly	byl +y
byrokratické	byrokratické
byste	byste
bytem	bytem
bytové	bytové
bytového	bytového
bytových	bytových
bytu	bytu
byty	byty
bytě	bytě
bytů	bytů
bytům	bytům
byznys	byznys
bázi	bázi
báša	báša
bílé	bílé
bílého	bílého
bývalo	bývalo
bývalé	bývalé
bývalém	bývalém
bývalí	bývalí
bývalých	bývalých
bývá	bývá
bývávaly	bývávaly
běhal	běhal
během	během
běhu	běhu
bělostný	bělostný
běžely	běžely
běžnou	běžnou
běžná	běžná
běžné	běžné
běžného	běžného
běžném	běžném
běžný	běžný
běžných	běžných
běžně	běžně
běžněji	běžněji
běží	běží
břemenem	břemenem
březina	březina
března	března
březnu	březnu
březovský	březovský
cable	cable
calgary	calgary
canstar	canstar
carina	carina
causa	causa
cech	cech
cechy	cechy
cejchují	cejchují
cekare	cekare
celek	celek
celkem	celkem
celkovou	celkovou
celková	celková
celkové	celkové
celkového	celkového
celkovými	celkovými
celkově	celkově
celky	celky
celků	celků
celní	celní
celního	celního
celoplošná	celoplošná
celoročního	celoročního
celoročně	celoročně
celostátní	celostátní
celou	celou
celoživotní	celoživotní
celá	celá
celé	celé
celého	celého
celém	celém
celý	celý
celých	celých
celým	celým
cementu	cementu
cementáren	cementáren
cena	cen +a
cenami	cenami
cennostmi	cennostmi
cenností	cenností
cenná	cenná
cenných	cenných
cenným	cenným
cennější	cennější
cenou	cenou
cenovek	cenovek
cenová	cenová
cenové	cenové
cenového	cenového
cenový	cenový
cenových	cenových
cenově	cenově
center	center
centra	centr +a
centrem	centrem
centru	centru
centrum	centrum
centry	centr +y
centrála	centrál +a
centrále	centrále
centrální	centrální
centrálního	centrálního
centrály	centrál +y
cenu	cenu
ceny	cen +y
cenách	cenách
cenám	cenám
cení	cení
ceníků	ceníků
ceně	ceně
ceněna	ceněna
ceněno	ceněno
ceněný	ceněný
certifikace	certifikace
certifikaci	certifikaci
certifikát	certifikát
certifikátu	certifikátu
certifikáty	certifikáty
cesta	cesta
cestní	cestní
cestou	cestou
cestovat	cestovat
cestovatelem	cestovatelem
cestovek	cestovek
cestovní	cestovní
cestovních	cestovních
cestovního	cestovního
cestovními	cestovními
cestovným	cestovným
cestu	cestu
cestující	cestující
cestujících	cestujících
cestách	cestách
cestám	cestám
cestě	cestě
chalupy	chalupy
charakter	charakter
charakterem	charakterem
charakteristikou	charakteristikou
charakterizovat	charakterizovat
charakterizuje	charakterizuje
charakteru	charakteru
chata	chat +a
chatu	chatu
chaty	chat +y
chce	chce
chceme	chceme
chcete	chcete
chci	chci
chemical	chemical
chemickou	chemickou
chemické	chemické
chemického	chemického
cherry	cherry
chipsy	chipsy
chiradent	chiradent
chladne	chladne
chmel	chmel
chmele	chmele
chod	chod
chodbě	chodbě
chodit	chodit
chodníků	chodníků
chodovci	chodovci
chodu	chodu
chodura	chodura
choděra	choděra
chomutov	chomutov
choroby	choroby
chovají	chovají
chová	chová
chování	chování
chromu	chromu
chránit	chránit
chtít	chtít
chtějí	chtějí
chtěl	chtěl
chtěla	chtěla
chtěli	chtěli
chudší	chudší
chuť	chuť
chvojka	chvojka
chvíle	chvíle
chvíli	chvíli
chyba	chyb +a
chybně	chybně
chybou	chybou
chybu	chybu
chyby	chyb +y
chybách	chybách
chybí	chybí
chybějící	chybějící
chybějícího	chybějícího
chyběl	chyběl
chybělo	chybělo
chybět	chybět
chystá	chystá
chytají	chytají
chytrou	chytrou
chytrovice	chytrovice
chytrý	chytrý
chápat	chápat
cibule	cibule
cibulí	cibulí
cihelen	cihelen
cihlářských	cihlářských
citelná	citelná
citelný	citelný
citlivou	citlivou
citlivého	citlivého
citlivý	citlivý
citlivých	citlivých
citovaný	citovaný
citát	citát
civilního	civilního
cizinců	cizinců
ciziny	ciziny
cizině	cizině
cizojazyčné	cizojazyčné
cizorodé	cizorodé
cizorodých	cizorodých
cizí	cizí
cizích	cizích
cizím	cizím
clarisworks	clarisworks
claude	claude
clům	clům
coby	coby
collections	collections
comma	comma
commercial	commercial
communicatio	communicatio
complex	complex
corona	corona
corp	corp
cosi	cosi
crown	crown
cyklu	cyklu
cyril	cyril
cévy	cévy
cézannovo	cézannovo
cíle	cíle
cílem	cílem
cílevědomý	cílevědomý
cílevědomě	cílevědomě
cíli	cíli
cílová	cílová
cílovým	cílovým
cílů	cílů
církvi	církvi
cítí	cítí
cítím	cítím
daishowa	daishowa
dají	dají
daklar	daklar
dala	dal +a
daleko	daleko
dali	dali
dalo	dalo
daly	dal +y
další	další
dalších	dalších
dalšího	dalšího
dalším	dalším
dalšími	dalšími
dani	dani
danica	danica
danou	danou
danzas	danzas
daná	daná
dané	dané
daném	daném
daní	daní
daních	daních
daný	daný
daným	daným
daně	daně
darem	darem
darovací	darovací
darovaný	darovaný
darování	darování
daru	daru
dary	dary
darů	darů
darům	darům
data	data
databance	databan +ce
databankou	databan +kou
databanky	databan +ky
databáze	databáze
databází	databází
datová	datová
datování	datování
david	david
daňovou	daňovou
daňová	daňová
daňové	daňové
daňového	daňového
daňový	daňový
daňových	daňových
daňovým	daňovým
dařilo	dařilo
daří	daří
dealerem	dealerem
dealery	dealery
definuje	definuje
deformací	deformací
degenerací	degenerací
degustaci	degustaci
degustační	degustační
dejte	dejte
dekorační	dekorační
deky	deky
delegace	delegace
delší	delší
demonstrovali	demonstrovali
demontovali	demontovali
denní	denní
denním	denním
denními	denními
denně	denně
denících	denících
deníky	deníky
deníků	deníků
depozitáře	depozitáře
derbyshire	derbyshire
deregulace	deregulace
deset	deset
deseti	deseti
desetiletí	desetiletí
desetiletích	desetiletích
desetina	desetin +a
desetiny	desetin +y
desetiprocentní	desetiprocentní
desetník	desetník
design	design
desky	desky
desítek	desítek
desítkový	desítkový
desítky	desítky
desítkách	desítkách
detailně	detailně
detektivních	detektivních
detekčních	detekčních
devadesátých	devadesátých
devalvace	devalvace
devalvační	devalvační
devizové	devizové
devizy	devizy
devět	devět
dezertní	dezertní
dezertního	dezertního
deště	deště
diakritikou	diakritikou
didaktické	didaktické
dietetické	dietetické
diferencí	diferencí
digital	digital
dika	di +k +a
dikcí	dikcí
dikové	dikové
diktafon	diktafon
diktafony	diktafony
diktoval	diktoval
diky	di +k +y
diků	diků
dikům	dikům
dimenze	dimenze
diplomat	diplomat
diplomatickým	diplomatickým
direct	direct
disciplíny	disciplíny
diskretance	diskretance
diskrétní	diskrétní
diskusi	diskusi
diskutovat	diskutovat
dispečinku	dispečinku
displej	displej
displejích	displejích
displejů	displejů
disponuje	disponuje
dispozici	dispozici
distanční	distanční
distribuce	distribuce
distribuci	distribuci
distribuovaná	distribuovaná
distribuuje	distribuuje
divadla	divadla
dividend	dividend
dividenda	dividend +a
dividendovou	dividendovou
dividendu	dividendu
dividendy	dividend +y
dividendách	dividendách
dividendě	dividendě
divil	divil
divit	divit
divize	divize
divu	divu
diváci	diváci
divíte	divíte
diář	diář
dlaní	dlaní
dlažba	dlažb +a
dlažbou	dlažbou
dlažbu	dlažbu
dlažby	dlažb +y
dlažeb	dlažeb
dlouho	dlouho
dlouhodobou	dlouhodobou
dlouhodobého	dlouhodobého
dlouhodobých	dlouhodobých
dlouhodobě	dlouhodobě
dlouhá	dlouhá
dlouhé	dlouhé
dlouhý	dlouhý
dluh	dluh
dluhy	dluhy
dluhů	dluhů
dlužila	dlužila
dlužnou	dlužnou
dlužníky	dlužníky
dnech	dnech
dnes	dnes
dneškem	dneškem
dnešní	dnešní
dnešních	dnešních
dnešním	dnešním
dnům	dnům
doba	dob +a
dobou	dobou
dobropis	dobropis
dobrou	dobrou
dobrovolnost	dobrovolnost
dobrovolnosti	dobrovolnosti
dobrovolné	dobrovolné
dobrovolně	dobrovolně
dobru	dobru
dobrá	dobrá
dobrák	dobrák
dobré	dobré
dobrého	dobrého
dobrý	dobrý
dobrých	dobrých
dobu	dobu
dobuduje	dobuduje
doby	dob +y
dobám	dobám
době	době
dobře	dobře
dobřichovic	dobřichovic
docela	docela
docentů	docentů
dochucovaná	dochucovaná
docházely	docházely
dochází	dochází
docházím	docházím
dodal	dodal
dodaných	dodaných
dodat	dodat
dodatečně	dodatečně
dodavatel	dodavatel
dodavatele	dodavatele
dodavatelem	dodavatelem
dodavatelů	dodavatelů
dodržet	dodržet
dodá	dodá
dodávají	dodávají
dodávající	dodávající
dodával	dodával
dodávat	dodávat
dodávek	dodávek
dodávka	dodáv +k +a
dodávku	dodávku
dodávky	dodáv +k +y
dodává	dodává
dohadování	dohadování
dohady	dohady
dohoda	dohod +a
dohodnout	dohodnout
dohodou	dohodou
dohodu	dohodu
dohody	dohod +y
dojde	dojde
dojdeme	dojdeme
dojdeš	dojdeš
dojednán	dojednán
dojem	dojem
dojmem	dojmem
dojít	dojít
dojíždět	dojíždět
dokazují	dokazují
doklad	doklad
dokladem	dokladem
doklady	doklady
dokládá	dokládá
dokonale	dokonale
dokonalá	dokonalá
dokonalý	dokonalý
dokonce	dokonce
dokončeného	dokončeného
dokončení	dokončení
dokončit	dokončit
dokončování	dokončování
dokud	dokud
dokumentace	dokumentace
dokumentu	dokumentu
dokumentů	dokumentů
dokázat	dokázat
dokáže	dokáže
dokážu	dokážu
dokáží	dokáží
doladit	doladit
dolar	dolar
dolarů	dolarů
dolaďování	dolaďování
dolehla	dolehla
dolní	dolní
doléhá	doléhá
dolů	dolů
doma	doma
domažlice	domažlice
domažlická	domažlická
domech	domech
domek	domek
domem	domem
domnívají	domnívají
domnívalo	domnívalo
domnívat	domnívat
domnívá	domnívá
domníváte	domníváte
domněnce	domněnce
domo	domo
domov	domov
domovních	domovních
domu	domu
domácnost	domácnost
domácnosti	domácnosti
domácností	domácností
domácí	domácí
domácích	domácích
domácího	domácího
domácím	domácím
domáhaly	domáhaly
domáhat	domáhat
domě	domě
domů	domů
donau	donau
donesl	donesl
donna	donna
donutila	donutila
dopadnete	dopadnete
dopis	dopis
dopisem	dopisem
dopisovatel	dopisovatel
dopisu	dopisu
dopisy	dopisy
dopisů	dopisů
doplnili	doplnili
doplnit	doplnit
doplnění	doplnění
doplňková	doplňková
doplňky	doplňky
doplňků	doplňků
doplňujeme	doplňujeme
doplňují	doplňují
dopolední	dopolední
doporučení	doporučení
doporučili	doporučili
doporučuje	doporučuje
doporučujeme	doporučujeme
doporučujete	doporučujete
doporučuji	doporučuji
doporučují	doporučují
doporučí	doporučí
doposud	doposud
dopouští	dopouští
dopouštěla	dopouštěla
dopouštění	dopouštění
doprava	doprav +a
dopravní	dopravní
dopravních	dopravních
dopravním	dopravním
dopravou	dopravou
dopravováni	dopravováni
dopravu	dopravu
dopravují	dopravují
dopravy	doprav +y
dopravě	dopravě
doprovody	doprovody
doprovázejí	doprovázejí
dopustili	dopustili
dopředu	dopředu
dorazily	dorazily
dorazí	dorazí
dorrek	dorrek
doručením	doručením
doručí	doručí
dosahovat	dosahovat
dosahuje	dosahuje
dosahujeme	dosahujeme
dosahují	dosahují
dosavadní	dosavadní
dosavadních	dosavadních
dosavadního	dosavadního
dosavadním	dosavadním
doslova	doslova
dospěla	dospěla
dospělého	dospělého
dost	dost
dostal	dostal
dostala	dostala
dostali	dostali
dostalo	dostalo
dostane	dostane
dostaneme	dostaneme
dostanete	dostanete
dostanou	dostanou
dostanu	dostanu
dostatek	dostatek
dostatečnou	dostatečnou
dostatečný	dostatečný
dostatečným	dostatečným
dostatečně	dostatečně
dosti	dosti
dostupné	dostupné
dostupných	dostupných
dostupnější	dostupnější
dostání	dostání
dostát	dostát
dostávají	dostávají
dostával	dostával
dostává	dostává
dostáváme	dostáváme
dostáváte	dostáváte
dosud	dosud
dosáhl	dosáhl
dosáhla	dosáhl +a
dosáhli	dosáhli
dosáhlo	dosáhlo
dosáhly	dosáhl +y
dosáhnout	dosáhnout
dotace	dotace
dotací	dotací
dotaz	dotaz
dotazníky	dotazníky
dotazu	dotazu
dotazy	dotazy
dotažení	dotažení
dotován	dotován
dotovány	dotovány
dotyčná	dotyčná
dotyčný	dotyčný
dotírají	dotírají
dotýkají	dotýkají
doucek	doucek
dousková	dousková
dovede	dovede
dovedou	dovedou
dovnitř	dovnitř
dovolenou	dovolenou
dovolená	dovolená
dovolené	dovolené
dovolilo	dovolilo
dovolit	dovolit
dovolí	dovolí
dovoz	dovoz
dovozce	dovozce
dovozem	dovozem
dovozní	dovozní
dovozu	dovozu
dovážen	dovážen
dovážené	dovážené
dovážených	dovážených
dováží	dováží
dovézt	dovézt
dovědět	dovědět
doznívání	doznívání
dozvím	dozvím
dozvěděli	dozvěděli
dočasné	dočasné
dočtete	dočtete
došel	došel
doškolovací	doškolovací
došlo	došlo
dožadovat	dožadovat
dožití	dožití
draho	draho
drahou	drahou
drahovice	drahovice
drahá	drahá
drahé	drahé
drancování	drancování
draze	draze
dražby	dražby
dražebního	dražebního
dražší	dražší
dražšími	dražšími
drceného	drceného
drobením	drobením
drobky	drobky
drobné	drobné
drobném	drobném
drobní	drobní
drobný	drobný
drobných	drobných
drobnější	drobnější
drogerii	drogerii
drogistické	drogistické
druh	druh
druhou	druhou
druhu	druhu
druhy	druhy
druhá	druhá
druhé	druhé
druhého	druhého
druhém	druhém
druhý	druhý
druhých	druhých
druhů	druhů
druzích	druzích
družstevních	družstevních
družstvo	družstvo
dráha	dráh +a
dráhy	dráh +y
drátkách	drátkách
drůbeže	drůbeže
držet	držet
držitelé	držitelé
držáku	držáku
drží	drží
dubna	dubna
dubnu	dubnu
ducha	ducha
duchu	duchu
duhu	duhu
dušan	dušan
duši	duši
dvacet	dvacet
dvaceti	dvaceti
dvacetník	dvacetník
dvakrát	dvakrát
dvanáct	dvanáct
dvanácti	dvanácti
dvanáctihodinovou	dvanáctihodinovou
dvanáctsettrojkou	dvanáctsettrojkou
dvoje	dvoje
dvojnásobek	dvojnásobek
dvojnásobné	dvojnásobné
dvojnásobně	dvojnásobně
dvorana	dvorana
dvou	dvou
dvoulůžkových	dvoulůžkových
dvouminutovou	dvouminutovou
dvouměsíční	dvouměsíční
dvouprocentní	dvouprocentní
dvoustranu	dvoustranu
dvoustraně	dvoustraně
dvěma	dvěma
dvěstěprocentní	dvěstěprocentní
dyba	dyb +a
dyby	dyb +y
dynamickou	dynamickou
dynamická	dynamická
dále	dále
dálnic	dálnic
dálnice	dálnice
dálnicích	dálnicích
dáme	dáme
dámskou	dámskou
dámské	dámské
dána	dána
dáno	dáno
dánové	dánové
dánska	dánska
dánsko	dánsko
dánsku	dánsku
dánská	dánská
dánské	dánské
dánský	dánský
dánských	dánských
dárce	dárce
dárek	dárek
dáreček	dáreček
dárkov	dárkov
dárkové	dárkové
dárkového	dárkového
dáte	dáte
dávají	dávají
dávala	dávala
dávalo	dávalo
dávat	dávat
dávky	dávky
dává	dává
dáváni	dáváni
délce	délce
déle	déle
désudry	désudry
díky	díky
díla	díl +a
dílech	dílech
dílem	dílem
dílna	díln +a
dílny	díln +y
dílně	dílně
dílo	dílo
dílu	dílu
díly	díl +y
dílčích	dílčích
dílčím	dílčím
dílů	dílů
dílům	dílům
dítě	dítě
dívka	dívka
díváte	díváte
düsseldorf	düsseldorf
dýchá	dýchá
děda	děda
dědečkovi	dědečkovi
dědictví	dědictví
dělají	dělají
dělat	dělat
dělba	dělba
dělené	dělené
dělení	dělení
dělenými	dělenými
dělila	dělila
dělit	dělit
dělníci	dělníci
dělník	dělník
dělníků	dělníků
dělá	dělá
dělám	dělám
dělí	dělí
dětem	dětem
děti	děti
dětská	dětská
dětské	dětské
dětským	dětským
dřeně	dřeně
dřeva	dřeva
dřevařské	dřevařské
dřevařskými	dřevařskými
dřevem	dřevem
dřevo	dřevo
dřevěné	dřevěné
dřevěného	dřevěného
dřevěných	dřevěných
dřív	dřív
dříve	dříve
dřívějšku	dřívějšku
dřívější	dřívější
důchodce	důchodce
důchodcům	důchodcům
důchodového	důchodového
důchody	důchody
důchodě	důchodě
důkazů	důkazů
důkladně	důkladně
důležitou	důležitou
důležitá	důležitá
důležité	důležité
důležitým	důležitým
důraz	důraz
důsledcích	důsledcích
důsledek	důsledek
důsledku	důsledku
důsledky	důsledky
důvod	důvod
důvodná	důvodná
důvodu	důvodu
důvody	důvody
důvodů	důvodů
důvěru	důvěru
důvěry	důvěry
důvěřivosti	důvěřivosti
důvěřivostí	důvěřivostí
důvěřiví	důvěřiví
důvěřivých	důvěřivých
džbánem	džbánem
džínsový	džínsový
editoru	editoru
edičního	edičního
efekt	efekt
efektivnost	efektivnost
efektivnosti	efektivnosti
efektivní	efektivní
ekologicky	ekologicky
ekologických	ekologických
ekonom	ekonom
ekonomech	ekonomech
ekonomice	ekonomi +ce
ekonomickou	ekonomic +kou
ekonomicky	ekonomic +ky
ekonomická	ekonomická
ekonomické	ekonomické
ekonomického	ekonomického
ekonomickém	ekonomickém
ekonomickému	ekonomickému
ekonomických	ekonomických
ekonomika	ekonomi +k +a
ekonomikami	ekonomikami
ekonomikou	ekonomi +kou
ekonomiku	ekonomiku
ekonomiky	ekonomi +k +y
ekonomikách	ekonomikách
ekonomikám	ekonomikám
ekonomové	ekonomové
ekonomy	ekonomy
ekostavby	ekostavby
ekvivalence	ekvivalence
electric	electric
elektrické	elektrické
elektronické	elektronické
elektroniku	elektroniku
elektroniky	elektroniky
elektrotechnického	elektrotechnického
elektrotechnický	elektrotechnický
elektrárny	elektrárny
elektrárně	elektrárně
elektřinu	elektřinu
elita	elita
eliášova	eliášova
emanovský	emanovský
eminentní	eminentní
energeticky	energeticky
energií	energií
energovodů	energovodů
engineering	engineering
epilepsií	epilepsií
epizodě	epizodě
estetické	estetické
estetickými	estetickými
etika	etika
etiku	etiku
europäische	europäische
eventualitami	eventualitami
evidence	evidence
evidenci	evidenci
evidovat	evidovat
eviduje	eviduje
evropa	evrop +a
evropská	evropská
evropské	evropské
evropského	evropského
evropských	evropských
evropu	evropu
evropy	evrop +y
evropě	evropě
existence	existence
existenci	existenci
existovat	existovat
existuje	existuje
existují	existují
existujícím	existujícím
expansion	expansion
experimentovat	experimentovat
experta	expert +a
expertní	expertní
experty	expert +y
expo	expo
export	export
exportem	exportem
exportu	exportu
exportéry	exportéry
exportérům	exportérům
exportéři	exportéři
expozice	expozice
expres	expres
externích	externích
extrémní	extrémní
fach	fach
fair	fair
fakt	fakt
fakta	fakta
faktorem	faktorem
faktory	faktory
faktorům	faktorům
faktu	faktu
fakultní	fakultní
falešných	falešných
falzifikát	falzifikát
falzifikátu	falzifikátu
falzifikáty	falzifikáty
falzifikátů	falzifikátů
farmaceutické	farmaceutické
fashion	fashion
fatální	fatální
favorité	favorité
faxem	faxem
faxy	faxy
federace	federace
fiktivním	fiktivním
filla	filla
filmování	filmování
filmů	filmů
filozofie	filozofie
filozofii	filozofii
filozofií	filozofií
finance	finance
financovány	financovány
financování	financování
financí	financí
finančnictví	finančnictví
finanční	finanční
finančních	finančních
finančního	finančního
finančním	finančním
finančnímu	finančnímu
finančně	finančně
fingovaná	fingovaná
fingované	fingované
finska	fins +ka
finsko	finsko
finskou	fins +kou
finském	finském
firem	firem
firemní	firemní
firemních	firemních
firemním	firemním
firma	firm +a
firmami	firmami
firmou	firmou
firmu	firmu
firmy	firm +y
firmám	firmám
firmě	firmě
fischer	fischer
fitness	fitness
fkim	fkim
fluktuaci	fluktuaci
fond	fond
fondech	fondech
fondem	fondem
fondu	fondu
fondy	fondy
fondů	fondů
fondům	fondům
forma	form +a
formed	formed
formou	formou
formu	formu
formulovaný	formulovaný
formulář	formulář
formuláře	formuláře
formy	form +y
formě	formě
forum	forum
foto	foto
fotografiemi	fotografiemi
foukal	foukal
francie	francie
francouzské	francouzské
francouzského	francouzského
francouzských	francouzských
francouzštině	francouzštině
francích	francích
frank	frank
frankfurt	frankfurt
franků	franků
františek	františek
fred	fred
frekvence	frekvence
fresek	fresek
fresky	fresky
fréz	fréz
frézovací	frézovací
frézy	frézy
frýdek	frýdek
frýdku	frýdku
ftalátů	ftalátů
fundovanou	fundovanou
fundovaných	fundovaných
funesem	funesem
fungoval	fungoval
funguje	funguje
funkce	funkce
funkcí	funkcí
fyzických	fyzických
fázi	fázi
fóbistickém	fóbistickém
fólie	fólie
fólii	fólii
fürstová	fürstová
gadouaová	gadouaová
galerie	galerie
galerii	galerii
galeriích	galeriích
gang	gang
gangy	gangy
garantovaných	garantovaných
garantovat	garantovat
garáži	garáži
gassin	gassin
gatt	gatt
gebarowský	gebarowský
generace	generace
general	general
generální	generální
generátorem	generátorem
genetické	genetické
giga	giga
globálnímu	globálnímu
gogh	gogh
goghů	goghů
goldair	goldair
golf	golf
gotiky	gotiky
gottlieb	gottlieb
grada	grada
graficky	graficky
grafického	grafického
grafika	grafika
grafikonu	grafikonu
grafu	grafu
grafy	grafy
grafům	grafům
gramy	gramy
gratulací	gratulací
group	group
guardian	guardian
gumové	gumové
génie	génie
géniové	géniové
hadr	hadr
hala	hala
hale	hale
haleš	haleš
halikarnass	halikarnass
halách	halách
haná	haná
harmonizován	harmonizován
hartmanem	hartmanem
havelka	havelka
havlíková	havlíková
havránek	havránek
havíř	havíř
heimtextil	heimtextil
hematologického	hematologického
henke	henke
herců	herců
heslem	heslem
hezkou	hezkou
historické	historické
historického	historického
historických	historických
historie	historie
historii	historii
historiků	historiků
historka	historka
hlad	hlad
hlasem	hlasem
hlav	hlav
hlava	hlav +a
hlavní	hlavní
hlavních	hlavních
hlavního	hlavního
hlavním	hlavním
hlavními	hlavními
hlavně	hlavně
hlavu	hlavu
hlavy	hlav +y
hlavě	hlavě
hledají	hledají
hledali	hledali
hledat	hledat
hlediska	hlediska
hledá	hledá
hledání	hledání
hledáte	hledáte
hledíme	hledíme
hliníkové	hliníkové
hlouběji	hlouběji
hloupostí	hloupostí
hluboko	hluboko
hluboké	hluboké
hluboký	hluboký
hlubší	hlubší
hmot	hmot
hmotně	hmotně
hnací	hnací
hnacím	hnacím
hned	hned
hnedka	hnedka
hnutí	hnutí
hnízdům	hnízdům
hobby	hobby
hochschule	hochschule
hodin	hodin
hodinek	hodinek
hodinky	hodinky
hodinového	hodinového
hodinách	hodinách
hodit	hodit
hodlá	hodlá
hodláte	hodláte
hodnocen	hodnocen
hodnocena	hodnocen +a
hodnoceny	hodnocen +y
hodnocení	hodnocení
hodnocením	hodnocením
hodnot	hodnot
hodnota	hodnot +a
hodnotné	hodnotné
hodnotných	hodnotných
hodnotou	hodnotou
hodnotu	hodnotu
hodnoty	hodnot +y
hodnotí	hodnotí
hodnotím	hodnotím
hodnotíte	hodnotíte
hodnotě	hodnotě
hodnověrný	hodnověrný
hodně	hodně
hodolanská	hodolanská
hody	hody
hodí	hodí
hofman	hofman
hoga	hoga
hojnosti	hojnosti
hokeje	hokeje
hokeji	hokeji
holandského	holandského
holdingu	holdingu
holická	holická
holiday	holiday
holomajzna	holomajzna
holomajznou	holomajznou
holub	holub
home	home
homolka	homolka
honorován	honorován
honoráře	honoráře
hora	hor +a
horizontu	horizontu
horké	horké
hornictví	hornictví
horní	horní
horskou	horskou
horské	horské
horských	horských
hory	hor +y
horách	horách
horšovský	horšovský
horší	horší
hospodské	hospodské
hospodářskou	hospodářs +kou
hospodářsky	hospodářs +ky
hospodářské	hospodářské
hospodářského	hospodářského
hospodářský	hospodářský
hospodářských	hospodářských
hospodářství	hospodářství
hostesky	hostesky
hosty	hosty
hostům	hostům
hotel	hotel
hotelech	hotelech
hotelem	hotelem
hotelové	hotelové
hotelový	hotelový
hotelových	hotelových
hotelu	hotelu
hotely	hotely
hotelů	hotelů
hotelům	hotelům
hotovou	hotovou
hotové	hotové
hotově	hotově
houbaření	houbaření
hovořil	hovořil
hovořili	hovořili
hovořilo	hovořilo
hovořit	hovořit
hovoří	hovoří
hovět	hovět
hořlavosti	hořlavosti
hrabové	hrabové
hrabství	hrabství
hrabák	hrabák
hrabáka	hrabáka
hrad	hrad
hradbách	hradbách
hradec	hradec
hradech	hradech
hradil	hradil
hradit	hradit
hrady	hrady
hradí	hradí
hraje	hraje
hrají	hrají
hranic	hranic
hranice	hranice
hranici	hranici
hranicí	hranicí
hranicích	hranicích
hranu	hranu
hrazeny	hrazeny
hrazené	hrazené
hraček	hraček
hrnec	hrnec
hrobka	hrobka
hromadného	hromadného
hromady	hromady
hromádek	hromádek
hromádku	hromádku
hrozbu	hrozbu
hrozně	hrozně
hrubé	hrubé
hrubého	hrubého
hrubý	hrubý
hrubě	hrubě
hrál	hrál
hráli	hráli
hrálo	hrálo
hrát	hrát
hudby	hudby
hudebních	hudebních
hudeček	hudeček
hudečka	hudečka
hugo	hugo
humana	humana
husi	husi
hutnictví	hutnictví
hvězd	hvězd
hybernů	hybernů
hygiena	hygiena
hygienici	hygienici
hygienické	hygienické
hygienika	hygienika
hygienu	hygienu
hynais	hynais
hynek	hynek
hypotetická	hypotetická
hábík	hábík
hádali	hádali
háje	háje
háša	háša
hřbitovů	hřbitovů
hřebenu	hřebenu
hřiště	hřiště
hřídelí	hřídelí
hůře	hůře
ibsenova	ibsenova
identifikace	identifikace
identifikaci	identifikaci
identifikační	identifikační
identifikovat	identifikovat
ideální	ideální
igor	igor
ihned	ihned
ilegální	ilegální
ilja	ilja
ilustrace	ilustrace
ilustraci	ilustraci
ilustrujme	ilustrujme
improvizace	improvizace
impulzy	impulzy
inaugurován	inaugurován
incommingu	incommingu
indexu	indexu
indikátor	indikátor
individuální	individuální
individuálně	individuálně
inflace	inflace
inflaci	inflaci
inflací	inflací
inform	inform
informace	informace
informacemi	informacemi
informaci	informaci
informací	informací
informacím	informacím
informatika	informatika
informační	informační
informačních	informačních
informačního	informačního
informačním	informačním
informovala	informovala
informovanosti	informovanosti
informovat	informovat
informovány	informovány
informuje	informuje
informují	informují
infrastruktury	infrastruktury
infrastruktuře	infrastruktuře
iniciativa	iniciativa
iniciovat	iniciovat
iniciátorem	iniciátorem
injektážní	injektážní
inspekce	inspekce
inspekci	inspekci
inspektorátem	inspektorátem
instalaci	instalaci
instalační	instalační
instalujete	instalujete
instituce	instituce
institucemi	institucemi
institucí	institucí
institucím	institucím
institut	institut
intenzivní	intenzivní
intepretace	intepretace
interakční	interakční
interhotelů	interhotelů
international	international
interní	interní
interních	interních
interstoff	interstoff
interupce	interupce
investic	investic
investice	investice
investici	investici
investiční	investiční
investičních	investičních
investičně	investičně
investor	investor
investory	investory
investorů	investorů
investovali	investovali
investovalo	investovalo
investovat	investovat
investování	investování
investoři	investoři
investuje	investuje
inzerce	inzerce
inzerované	inzerované
inzerát	inzerát
inzerátu	inzerátu
inzerátů	inzerátů
inženýrském	inženýrském
italská	italská
italském	italském
italských	italských
itálie	itálie
itálií	itálií
ivana	ivana
ivančic	ivančic
izolačních	izolačních
izraeli	izraeli
izraelské	izraelské
jablky	jablky
jablunkov	jablunkov
jací	jací
jadran	jadran
jakmile	jakmile
jako	jako
jakost	jakost
jakosti	jakosti
jakou	jakou
jakoukoliv	jakoukoliv
jakož	jakož
jaká	jaká
jakákoliv	jakákoliv
jaké	jaké
jakéhosi	jakéhosi
jakékoli	jakékoli
jakém	jakém
jakémkoli	jakémkoli
jakému	jakému
jakési	jakési
jaký	jaký
jakým	jakým
jakýmsi	jakýmsi
jakýsi	jakýsi
jalta	jalta
james	james
jana	jana
janočková	janočková
janáček	janáček
japonci	japonci
japonska	japons +ka
japonsko	japonsko
japonskou	japons +kou
japonské	japonské
japonský	japonský
japonských	japonských
japonštině	japonštině
jarních	jarních
jaro	jaro
jaromír	jaromír
jaroslav	jaroslav
jaroslava	jaroslava
jasno	jasno
jasná	jasná
jasné	jasné
jasně	jasně
jazyce	jazy +ce
jazykové	jazykové
jazykově	jazykově
jazyky	jazy +ky
jazyků	jazyků
jdou	jdou
jean	jean
jeden	jeden
jedenkrát	jedenkrát
jedinou	jedinou
jediná	jediná
jediné	jediné
jediný	jediný
jediným	jediným
jedině	jedině
jedna	jedn +a
jednak	jednak
jednal	jednal
jednat	jednat
jedno	jedno
jednoduché	jednoduché
jednoduchého	jednoduchého
jednoduchý	jednoduchý
jednoduchým	jednoduchým
jednoduše	jednoduše
jednoho	jednoho
jednoletý	jednoletý
jednom	jednom
jednopatrová	jednopatrová
jednoročnímu	jednoročnímu
jednorázové	jednorázové
jednorázový	jednorázový
jednotek	jednotek
jednotky	jednotky
jednotlivci	jednotlivci
jednotlivců	jednotlivců
jednotlivcům	jednotlivcům
jednotlivá	jednotlivá
jednotlivé	jednotlivé
jednotliví	jednotliví
jednotlivých	jednotlivých
jednotlivě	jednotlivě
jednotné	jednotné
jednotném	jednotném
jednotný	jednotný
jednotvárná	jednotvárná
jednou	jednou
jednoznačná	jednoznačná
jednoznačně	jednoznačně
jednu	jednu
jedny	jedn +y
jedná	jedná
jednáme	jednáme
jednání	jednání
jednáních	jednáních
jedné	jedné
jedním	jedním
jeho	jeho
jehož	jehož
jejich	jejich
jejichž	jejichž
její	její
jejích	jejích
jejím	jejím
jejími	jejími
jejímu	jejímu
jejímž	jejímž
jejíž	jejíž
jeka	jeka
jelikož	jelikož
jemu	jemu
jenom	jenom
jenomže	jenomže
jenže	jenže
jeruzalémská	jeruzalémská
jeruzalémské	jeruzalémské
jeseník	jeseník
jeseníku	jeseníku
jeseníky	jeseníky
jest	jest
jestli	jestli
jestliže	jestliže
jevu	jevu
jezdilo	jezdilo
jezdily	jezdily
jezdit	jezdit
jezdí	jezdí
jezdím	jezdím
jezer	jezer
jezerce	jezerce
ještě	ještě
jich	jich
jichž	jichž
jiko	jiko
jimi	jimi
jimž	jimž
jinak	jinak
jinam	jinam
jinde	jinde
jindy	jindy
jinou	jinou
jiná	jiná
jiné	jiné
jiného	jiného
jiném	jiném
jinému	jinému
jiní	jiní
jiný	jiný
jiných	jiných
jiným	jiným
jinými	jinými
jiskření	jiskření
jisti	jisti
jistotou	jistotou
jistotu	jistotu
jistou	jistou
jisté	jisté
jistí	jistí
jistě	jistě
jičín	jičín
jičína	jičína
jiří	jiří
jižní	jižní
jižními	jižními
jmenovaných	jmenovaných
jmenování	jmenování
jména	jména
jménem	jménem
jméno	jméno
jmění	jmění
jměním	jměním
john	john
joint	joint
jones	jones
josef	josef
journalismus	journalismus
jsem	jsem
jsme	jsme
jsou	jsou
jste	jste
judr	judr
julia	julia
jupa	jupa
juřeník	juřeník
jádra	jádra
jádrech	jádrech
jádro	jádro
jánoška	jánoška
jídla	jídla
jídlem	jídlem
jídlo	jídlo
jídlu	jídlu
jízd	jízd
kabelem	kabelem
kadeřnictví	kadeřnictví
kadlec	kadlec
kaiserova	kaiserova
kaizen	kaizen
kaktus	kaktus
kalamitu	kalamitu
kalamitě	kalamitě
kalendář	kalendář
kalkulačka	kalkulač +ka
kalkulačkou	kalkulač +kou
kalkulačku	kalkulačku
kalkuloval	kalkuloval
kalkulovali	kalkulovali
kalkulujme	kalkulujme
kalorií	kalorií
kalvoda	kalvoda
kamene	kamene
kamenem	kamenem
kameniva	kameniva
kamenné	kamenné
kamil	kamil
kamion	kamion
kamionu	kamionu
kamionů	kamionů
kamkoliv	kamkoliv
kanada	kanad +a
kanadskou	kanadskou
kanadská	kanadská
kanadské	kanadské
kanadském	kanadském
kanadský	kanadský
kanadských	kanadských
kanadským	kanadským
kanadskými	kanadskými
kanady	kanad +y
kanadě	kanadě
kanadští	kanadští
kanaďané	kanaďané
kanaďanů	kanaďanů
kancelář	kancelář
kanceláře	kanceláře
kancelářského	kancelářského
kancelářských	kancelářských
kanceláří	kanceláří
kandidáta	kandidát +a
kandidátech	kandidátech
kandidáty	kandidát +y
kanál	kanál
kanály	kanály
kaolinu	kaolinu
kapacit	kapacit
kapacitu	kapacitu
kapacity	kapacity
kapesné	kapesné
kapitole	kapitole
kapitoly	kapitoly
kapitál	kapitál
kapitálem	kapitálem
kapitálové	kapitálové
kapitálového	kapitálového
kapitálovém	kapitálovém
kapitálový	kapitálový
kapitálových	kapitálových
kapitálovým	kapitálovým
kapitálu	kapitálu
kapli	kapli
kaplí	kaplí
kapsy	kapsy
karcinogenní	karcinogenní
karel	karel
karetní	karetní
karl	karl
karla	karla
karlem	karlem
karlovy	karlovy
karlových	karlových
karlík	karlík
karlíně	karlíně
karneval	karneval
karol	karol
karton	karton
kartonu	kartonu
karty	karty
karviná	karviná
kasičky	kasičky
katalog	katalog
katalogová	katalogová
katalogové	katalogové
katalogu	katalogu
katalogy	katalogy
katalogů	katalogů
katalozích	katalozích
kategorie	kategorie
kategoriích	kategoriích
kaván	kaván
kaváren	kaváren
kavárna	kavárna
kazet	kazet
kazety	kazety
kazimír	kazimír
kačer	kačer
kaňa	kaňa
každopádně	každopádně
každoroční	každoroční
každou	každou
každá	každá
každé	každé
každého	každého
každém	každém
každý	každý
každým	každým
kdežto	kdežto
kdokoli	kdokoli
kdosi	kdosi
kdož	kdož
kdyby	kdyby
kdykoli	kdykoli
kdykoliv	kdykoliv
kdysi	kdysi
když	když
keprník	keprník
keramických	keramických
keřů	keřů
kilometrů	kilometrů
kina	kina
kladen	kladen
kladné	kladné
kladně	kladně
klamavou	klamavou
klasické	klasické
klasického	klasického
klasický	klasický
klasickým	klasickým
klasifikovat	klasifikovat
klatovská	klatovská
klenotů	klenotů
klesajícího	klesajícího
klesat	klesat
klesl	klesl
klid	klid
klidné	klidné
klidném	klidném
klidně	klidně
klient	klient
klienta	klient +a
klientela	klientel +a
klientelu	klientelu
klientely	klientel +y
klienti	klienti
klientovi	klientovi
klienty	klient +y
klientů	klientů
klimatizaci	klimatizaci
kliniky	kliniky
kluziewicz	kluziewicz
kluzišti	kluzišti
klára	klára
klávesnice	klávesnice
klášterů	klášterů
klíč	klíč
kniha	knih +a
knihu	knihu
knihy	knih +y
knize	knize
knížce	kníž +ce
knížek	knížek
knížku	knížku
knížky	kníž +ky
knüpfer	knüpfer
koberce	koberce
kodaňská	kodaňská
kodexů	kodexů
kodifikující	kodifikující
koeficient	koeficient
koho	koho
kojit	kojit
koktejly	koktejly
kola	kola
kolapsu	kolapsu
kole	kole
kolech	kolech
kolego	kolego
kolegové	kolegové
kolegu	kolegu
kolejní	kolejní
kolekci	kolekci
kolektivní	kolektivní
kolem	kolem
kolemjdoucí	kolemjdoucí
kolik	kolik
kolo	kolo
koloritu	koloritu
koluje	koluje
kolářská	kolářská
kolébkou	kolébkou
kolín	kolín
kolísavá	kolísavá
kolísá	kolísá
kombinace	kombinace
kombinaci	kombinaci
kombinací	kombinací
kombinované	kombinované
kombinovat	kombinovat
komerční	komerční
komerčního	komerčního
komerčně	komerčně
komfort	komfort
komise	komise
komisi	komisi
komisní	komisní
komisním	komisním
komora	komor +a
komory	komor +y
komparativní	komparativní
kompenzovat	kompenzovat
kompetenci	kompetenci
kompetencí	kompetencí
komplet	komplet
kompletizaci	kompletizaci
kompletní	kompletní
kompletních	kompletních
kompletními	kompletními
komplex	komplex
komplexní	komplexní
komplikace	komplikace
komplikované	komplikované
komplikovanější	komplikovanější
komponentů	komponentů
kompromis	kompromis
komu	komu
komunikaci	komunikaci
komunikačního	komunikačního
komunální	komunální
komunálních	komunálních
konal	konal
konala	konal +a
konaly	konal +y
konce	konce
koncem	koncem
konceptem	konceptem
konci	konci
koncipováním	koncipováním
konec	konec
koneckonců	koneckonců
konečnou	konečnou
konečný	konečný
konečně	konečně
konfederace	konfederace
konfekce	konfekce
konfiskační	konfiskační
konflikt	konflikt
konformní	konformní
kongresech	kongresech
konkretizace	konkretizace
konkrétní	konkrétní
konkrétních	konkrétních
konkrétně	konkrétně
konkurence	konkurence
konkurenci	konkurenci
konkurencí	konkurencí
konkurenta	konkurenta
konkurenti	konkurenti
konkurenční	konkurenční
konkurenčních	konkurenčních
konkurenčního	konkurenčního
konkurenčním	konkurenčním
konkurečním	konkurečním
konkurzní	konkurzní
konkurzu	konkurzu
konstatovat	konstatovat
konstatování	konstatování
konstatuje	konstatuje
konstrukce	konstrukce
kontakt	kontakt
kontaktu	kontaktu
kontakty	kontakty
kontejnerů	kontejnerů
kontinentální	kontinentální
konto	konto
kontraindikace	kontraindikace
kontraktační	kontraktační
kontraktačních	kontraktačních
kontraverzní	kontraverzní
kontrolní	kontrolní
kontrolního	kontrolního
kontrolnímu	kontrolnímu
kontrolou	kontrolou
kontrolované	kontrolované
kontrolovatelnou	kontrolovatelnou
kontrolu	kontrolu
kontrolují	kontrolují
kontroly	kontroly
konvertibility	konvertibility
konzervace	konzervace
konzervy	konzervy
konzultace	konzultace
konzultaci	konzultaci
konzumace	konzumace
konzumaci	konzumaci
konče	konče
končí	končí
kooperace	kooperace
kooperuje	kooperuje
kooperujících	kooperujících
koordinaci	koordinaci
koordinací	koordinací
kopeckým	kopeckým
kopii	kopii
kopií	kopií
kopiích	kopiích
kopírky	kopírky
korektní	korektní
korelaci	korelaci
korespondence	korespondence
korespondenci	korespondenci
korespondenční	korespondenční
korespondenčními	korespondenčními
korn	korn
korun	korun
koruna	korun +a
korunu	korunu
koruny	korun +y
korunách	korunách
koruně	koruně
korupce	korupce
kosmetické	kosmetické
kosmetika	kosmeti +k +a
kosmetiky	kosmeti +k +y
kosmických	kosmických
kostek	kostek
kostely	kostely
kostelů	kostelů
kostní	kostní
kosárek	kosárek
kotvě	kotvě
kouli	kouli
koupe	koupe
koupel	koupel
koupele	koupele
koupelnu	koupelnu
koupelny	koupelny
koupelové	koupelové
koupených	koupených
koupete	koupete
koupi	koupi
koupil	koupil
koupili	koupili
koupit	koupit
koupání	koupání
koupí	koupí
koupíme	koupíme
koupíte	koupíte
koupě	koupě
koupěchtivých	koupěchtivých
koupěschopnosti	koupěschopnosti
koupěschopné	koupěschopné
kovovýroby	kovovýroby
kováře	kováře
kovářské	kovářské
kořenovou	kořenovou
koše	koše
kožené	kožené
koženého	koženého
kožešin	kožešin
kožešiny	kožešiny
krach	krach
krade	krade
kraji	kraji
krajinka	krajin +k +a
krajinky	krajin +k +y
krajinomalba	krajinomalba
krajinář	krajinář
krajině	krajině
krajských	krajských
kratší	kratší
kravata	kravata
krejčovské	krejčovské
krejčí	krejčí
krems	krems
kremsu	kremsu
kresba	kresba
kresbě	kresbě
kriminalisté	kriminalisté
kriminalistů	kriminalistů
kriminální	kriminální
kristiana	kristiana
kristů	kristů
kritiků	kritiků
kritizují	kritizují
kritéria	kritéria
kritériem	kritériem
kritérií	kritérií
kritériím	kritériím
krize	krize
krizi	krizi
krkonoších	krkonoších
krku	krku
krocích	krocích
krok	krok
krokem	krokem
kroky	kroky
kromě	kromě
kronos	kronos
kruh	kruh
kruhy	kruhy
kruhů	kruhů
krumlova	krumlova
kruzích	kruzích
kryty	kryty
krytí	krytí
krácení	krácení
krádeže	krádeže
kráječ	kráječ
krále	krále
králové	králové
krám	krám
krámků	krámků
krásnou	krásnou
krásná	krásná
krásné	krásné
krásný	krásný
krásnější	krásnější
krátkodobého	krátkodobého
krátkou	krátkou
krátké	krátké
krávu	krávu
kráčíš	kráčíš
kréta	kréta
kterou	kterou
která	která
které	které
kterého	kterého
kterémkoliv	kterémkoliv
kterému	kterému
který	který
kterých	kterých
kterým	kterým
kterými	kterými
kteří	kteří
kubistickém	kubistickém
kubišta	kubišta
kubín	kubín
kubů	kubů
kuchyní	kuchyní
kuchyně	kuchyně
kuchyňků	kuchyňků
kulisu	kulisu
kultivovat	kultivovat
kultura	kultur +a
kulturní	kulturní
kulturních	kulturních
kulturního	kulturního
kulturními	kulturními
kultury	kultur +y
kumuluje	kumuluje
kuneš	kuneš
kunsthistorici	kunsthistorici
kunsthistoriky	kunsthistoriky
kunášek	kunášek
kupce	kupce
kupci	kupci
kupní	kupní
kupodivu	kupodivu
kuponovky	kuponovky
kuponovou	kuponovou
kuponové	kuponové
kuponových	kuponových
kupony	kupony
kuponů	kuponů
kupuje	kupuje
kupují	kupují
kupující	kupující
kurs	kurs
kurty	kurty
kurz	kurz
kurzech	kurzech
kurzu	kurzu
kurzy	kurzy
kurzů	kurzů
kurýrní	kurýrní
kurýry	kurýry
kusech	kusech
kusů	kusů
kuřete	kuřete
kvalifikace	kvalifikace
kvalifikovaní	kvalifikovaní
kvalifikovaně	kvalifikovaně
kvalit	kvalit
kvalita	kvalit +a
kvalitativní	kvalitativní
kvalitní	kvalitní
kvalitním	kvalitním
kvalitně	kvalitně
kvalitou	kvalitou
kvalitu	kvalitu
kvality	kvalit +y
kvalitách	kvalitách
kvalitě	kvalitě
kvantitativní	kvantitativní
kvestor	kvestor
kvést	kvést
kvótu	kvótu
kvóty	kvóty
květa	květa
května	května
květnu	květnu
kvůli	kvůli
kypr	kypr
kyslíku	kyslíku
kytka	kytka
kácejících	kácejících
kádrových	kádrových
kánoích	kánoích
káva	káva
kázně	kázně
kódem	kódem
kódy	kódy
kódů	kódů
křemíkové	křemíkové
křesle	křesle
křivé	křivé
křišťálové	křišťálové
kříže	kříže
kříži	kříži
kůže	kůže
kůži	kůži
labem	labem
laciná	laciná
laciněji	laciněji
lacinější	lacinější
lacinějšími	lacinějšími
ladislav	ladislav
lahůdkami	lahůdkami
laku	laku
lallier	lallier
lalomde	lalomde
lampy	lampy
lanciger	lanciger
lapkové	lapkové
laptop	laptop
laptopům	laptopům
leasing	leasing
leasingovou	leasingovou
leasingová	leasingová
leasingové	leasingové
leasingový	leasingový
leasingových	leasingových
lebeda	lebeda
leccos	leccos
leden	leden
ledna	ledna
lednu	lednu
ledního	ledního
ledním	ledním
ledový	ledový
ledu	ledu
ledviny	ledviny
ledy	ledy
legerova	legerova
legislativa	legislativ +a
legislativní	legislativní
legislativně	legislativně
legislativy	legislativ +y
legální	legální
legálně	legálně
lehce	lehce
lehátka	lehátka
lektorkám	lektorkám
lepidla	lepidla
lepší	lepší
lepšího	lepšího
lepším	lepším
lepšímu	lepšímu
lese	lese
lesní	lesní
lesního	lesního
lesostavby	lesostavby
letech	letech
leteckou	letec +kou
letecky	letec +ky
letecké	letecké
leteckém	leteckém
letecký	letecký
leteckých	leteckých
letenka	letenka
letenská	letenská
letité	letité
letišti	letišti
letiště	letiště
letních	letních
letos	letos
letoun	letoun
letounu	letounu
letounů	letounů
letoviska	letoviska
letošní	letošní
letošního	letošního
letošním	letošním
lety	lety
leták	leták
letáků	letáků
letáčků	letáčků
leté	leté
letí	letí
letů	letů
levné	levné
levně	levně
levněji	levněji
levnější	levnější
levnějších	levnějších
levnějšího	levnějšího
levorukých	levorukých
leví	leví
levých	levých
ležela	ležela
ležet	ležet
ležákem	ležákem
leží	leží
ležíte	ležíte
lhůtou	lhůtou
lhůtu	lhůtu
liber	liber
liberalizace	liberalizace
liberálním	liberálním
libovolný	libovolný
licence	licence
licenci	licenci
lidech	lidech
lidem	lidem
lidi	lidi
lidmi	lidmi
lidové	lidové
lidových	lidových
lidské	lidské
lidu	lidu
lidé	lidé
lidí	lidí
likvidace	likvidace
likvidační	likvidační
likvidačního	likvidačního
likvidačním	likvidačním
likvidovat	likvidovat
limitech	limitech
limitována	limitována
limitováno	limitováno
limity	limity
limitů	limitů
linek	linek
lineární	lineární
linku	linku
linky	linky
lisem	lisem
list	list
listopadu	listopadu
listu	listu
listy	listy
listě	listě
litera	litera
literatura	literatura
literatuře	literatuře
litinová	litinová
litoměřice	litoměřice
litrů	litrů
lišil	lišil
liší	liší
logické	logické
logiku	logiku
lokalizována	lokalizována
lolek	lolek
loni	loni
loterie	loterie
louise	louise
louka	louka
lounsku	lounsku
loupež	loupež
loupeže	loupeže
loupeží	loupeží
loveckou	loveckou
lovosic	lovosic
lovosického	lovosického
lovosicích	lovosicích
loňského	loňského
loňském	loňském
ložnice	ložnice
ložní	ložní
ludmila	ludmila
lukrativní	lukrativní
lumír	lumír
luxe	luxe
luňák	luňák
luňákem	luňákem
lužnicí	lužnicí
lyžaře	lyžaře
lyžařskou	lyžařskou
lyžování	lyžování
lyžích	lyžích
láce	láce
lákají	lákají
lánský	lánský
látek	látek
látka	lát +k +a
látky	lát +k +y
lázeňská	lázeňská
lázeňské	lázeňské
lázeňského	lázeňského
lázeňský	lázeňský
lázeňských	lázeňských
lázní	lázní
lázně	lázně
lékař	lékař
lékaře	lékaře
lékaři	lékaři
lékařské	lékařské
lékařský	lékařský
lékařů	lékařů
lékem	lékem
léky	léky
lékárnám	lékárnám
lékárně	lékárně
léků	léků
lépe	lépe
léta	léta
létající	létající
léto	léto
létě	létě
léčba	léčba
léčbě	léčbě
léčebné	léčebné
léčebných	léčebných
léčení	léčení
léčením	léčením
léčí	léčí
líbily	líbily
líbit	líbit
lístky	lístky
lůžka	lůžka
lůžkové	lůžkové
lůžkovém	lůžkovém
lůžkových	lůžkových
macintosh	macintosh
macurově	macurově
magazínem	magazínem
magnetické	magnetické
majetek	majetek
majetkem	majetkem
majetkových	majetkových
majetku	majetku
majitel	majitel
majitele	majitele
majitelem	majitelem
majiteli	majiteli
majitelka	majitelka
majitelé	majitelé
majitelů	majitelů
majoritní	majoritní
mají	mají
makléřů	makléřů
makroekonomickému	makroekonomickému
malby	malby
maličkosti	maličkosti
malkovského	malkovského
maloobchodním	maloobchodním
malou	malou
malovala	malovala
malovaný	malovaný
malta	malta
malují	malují
malá	malá
malé	malé
malého	malého
malém	malém
malíře	malíře
malířského	malířského
malířství	malířství
malý	malý
malých	malých
malým	malým
management	management
managementu	managementu
manager	manager
manažera	manažera
manažere	manažere
manažerské	manažerské
manažerského	manažerského
manažerský	manažerský
manažerským	manažerským
manažerů	manažerů
manažerům	manažerům
manažeři	manažeři
manipulační	manipulační
manual	manual
manžel	manžel
manžela	manžela
manželce	manžel +ce
manželka	manžel +ka
manželkou	manžel +kou
manželku	manželku
manželské	manželské
manželů	manželů
manželův	manželův
mapujeme	mapujeme
mapě	mapě
maratónem	maratónem
marce	mar +ce
marek	marek
marines	marines
mariánské	mariánské
mariánských	mariánských
marka	mar +ka
markest	markest
market	market
marketing	marketing
marketingovou	marketingovou
marketingové	marketingové
marketingového	marketingového
marketingový	marketingový
marketingově	marketingově
marketingu	marketingu
markýzy	markýzy
marold	marold
mart	mart
marta	marta
martikán	martikán
martin	martin
martina	martina
marže	marže
marži	marži
marží	marží
masitá	masitá
mast	mast
masážní	masážní
masívní	masívní
materiál	materiál
materiálem	materiálem
materiálu	materiálu
materiály	materiály
materiálů	materiálů
mateřinku	mateřinku
mateřském	mateřském
matrace	matrace
mausola	mausola
maxima	maxima
maximum	maximum
maximálně	maximálně
mazareanu	mazareanu
maďarskem	maďarskem
maďarských	maďarských
mařáka	mařáka
mařákovců	mařákovců
mařákovec	mařákovec
mařákovi	mařákovi
mechanicky	mechanicky
mechaniky	mechaniky
mechanismem	mechanismem
mechanismy	mechanismy
mechanizace	mechanizace
mechanizačního	mechanizačního
media	media
menu	menu
menší	menší
menších	menších
mepha	mepha
metoda	metod +a
metodika	metodika
metodou	metodou
metodu	metodu
metody	metod +y
metodám	metodám
metrologii	metrologii
metrostav	metrostav
metrová	metrová
metrů	metrů
metují	metují
mezd	mezd
mezeru	mezeru
mezi	mezi
mezilidských	mezilidských
meziměstské	meziměstské
mezinárodní	mezinárodní
mezinárodního	mezinárodního
michael	michael
microsoftu	microsoftu
mikrobiologické	mikrobiologické
mikrobusy	mikrobusy
mikuláše	mikuláše
milan	milan
milencem	milencem
miliard	miliard
miliardu	miliardu
miliardy	miliardy
miliardách	miliardách
milion	milion
milionový	milionový
milionu	milionu
miliony	miliony
milionů	milionů
milovníky	milovníky
mimo	mimo
mimopražští	mimopražští
mimořádný	mimořádný
mimořádných	mimořádných
mimořádně	mimořádně
mimoškolními	mimoškolními
minařík	minařík
minimum	minimum
minimální	minimální
minimálně	minimálně
ministerstva	ministerstva
ministerstvem	ministerstvem
ministerstvo	ministerstvo
ministerstvu	ministerstvu
ministr	ministr
ministra	ministra
ministrů	ministrů
minisys	minisys
minule	minule
minulost	minulost
minulosti	minulosti
minulé	minulé
minulého	minulého
minulém	minulém
minulý	minulý
minulých	minulých
minut	minut
minutu	minutu
minuty	minuty
miraga	miraga
miroslav	miroslav
mistra	mistra
mistrně	mistrně
mistrů	mistrů
mizí	mizí
mladou	mladou
mladé	mladé
mladého	mladého
mladí	mladí
mladší	mladší
mluvilo	mluvilo
mléce	mléce
mléčné	mléčné
mnichově	mnichově
mnoha	mnoha
mnohamilionové	mnohamilionové
mnohdy	mnohdy
mnohem	mnohem
mnoho	mnoho
mnohých	mnohých
mnohým	mnohým
mnozí	mnozí
množství	množství
moci	moci
modernizace	modernizace
modernizaci	modernizaci
moderní	moderní
moderního	moderního
moderně	moderně
mohanem	mohanem
mohl	mohl
mohla	mohl +a
mohli	mohli
mohlo	mohlo
mohly	mohl +y
mohou	mohou
mohu	mohu
moje	moje
moji	moji
mojí	mojí
mojžíšovy	mojžíšovy
momentální	momentální
momentálně	momentálně
monitory	monitory
monopol	monopol
monopolu	monopolu
montreal	montreal
montrealské	montrealské
montrealského	montrealského
montrealu	montrealu
montáž	montáž
montáži	montáži
morava	morav +a
moravou	moravou
moravskou	moravskou
moravské	moravské
moravského	moravského
moravských	moravských
moravy	morav +y
moravě	moravě
mostě	mostě
motiv	motiv
motivací	motivací
motivační	motivační
motivačním	motivačním
motivováni	motivováni
motivu	motivu
motivují	motivují
motole	motole
motorem	motorem
motoristická	motoristická
motoristické	motoristické
motorlet	motorlet
motorletem	motorletem
motorletu	motorletu
motorová	motorová
motorových	motorových
motorovými	motorovými
motoru	motoru
motorů	motorů
moučníky	moučníky
mozkovou	mozkovou
mozkové	mozkové
mozku	mozku
moře	moře
mořem	mořem
možno	možno
možnost	možnost
možnostech	možnostech
možnosti	možnosti
možnostmi	možnostmi
možností	možností
možná	možná
možné	možné
možný	možný
možných	možných
možným	možným
možnými	možnými
mraky	mraky
mravenčí	mravenčí
mravy	mravy
mrazem	mrazem
mrazáky	mrazáky
musejí	musejí
musela	musel +a
museli	museli
muselo	muselo
musely	musel +y
muset	muset
music	music
musilová	musilová
musí	musí
musím	musím
musíme	musíme
muzea	muzea
muzeí	muzeí
muzeích	muzeích
mužem	mužem
muži	muži
mužů	mužů
mydlení	mydlení
myjete	myjete
mysleli	mysleli
mysli	mysli
myslitelné	myslitelné
myslitelný	myslitelný
myslí	myslí
myslím	myslím
myslíte	myslíte
mytí	mytí
myši	myši
myšlenku	myšlenku
myšlení	myšlení
myšlením	myšlením
mzda	mzd +a
mzdou	mzdou
mzdové	mzdové
mzdy	mzd +y
mzdám	mzdám
mzdě	mzdě
málo	málo
málokde	málokde
málokterý	málokterý
máme	máme
mánes	mánes
mánesové	mánesové
mání	mání
másla	másla
máte	máte
mávat	mávat
méně	méně
míchy	míchy
míra	mír +a
mírně	mírně
mírou	mírou
míru	míru
míry	mír +y
míst	míst
místa	místa
místech	místech
místek	místek
místenek	místenek
místenkových	místenkových
místku	místku
místnosti	místnosti
místní	místní
místních	místních
místním	místním
místo	místo
místě	místě
mívají	mívají
mívá	mívá
míře	míře
míří	míří
módní	módní
módu	módu
módy	módy
mých	mých
mýdla	mýdla
měkká	měkká
měla	měl +a
měli	měli
mělo	mělo
měly	měl +y
měna	měn +a
měnit	měnit
měnu	měnu
měny	měn +y
mění	mění
měnící	měnící
měst	měst
města	města
městech	městech
městečko	městečko
město	město
městskou	městskou
městského	městského
městských	městských
městu	městu
městě	městě
měsíc	měsíc
měsíce	měsíce
měsících	měsících
měsíců	měsíců
měsíční	měsíční
měsíčním	měsíčním
měsíčně	měsíčně
měření	měření
měřicí	měřicí
měřicích	měřicích
měřiče	měřiče
měřičích	měřičích
měří	měří
měřítka	měřítka
měřítku	měřítku
mšené	mšené
může	může
můžeme	můžeme
můžete	můžete
nabyvatel	nabyvatel
nabídce	nabíd +ce
nabídek	nabídek
nabídka	nabíd +k +a
nabídkou	nabíd +kou
nabídkové	nabídkové
nabídku	nabídku
nabídky	nabíd +k +y
nabídkách	nabídkách
nabídli	nabídli
nabídne	nabídne
nabídnout	nabídnout
nabídnut	nabídnut
nabídnuty	nabídnuty
nabízejí	nabízejí
nabízející	nabízející
nabízejících	nabízejících
nabízen	nabízen
nabízeny	nabízeny
nabízené	nabízené
nabízeného	nabízeného
nabízení	nabízení
nabízených	nabízených
nabízet	nabízet
nabízí	nabízí
nachytat	nachytat
nacházejí	nacházejí
nacházela	nacházela
nacházeli	nacházeli
nachází	nachází
nadbytek	nadbytek
nadcházející	nadcházející
nadcházejícím	nadcházejícím
nadmořské	nadmořské
nadměrně	nadměrně
nadnesená	nadnesená
nadprůměrnými	nadprůměrnými
nadsazovat	nadsazovat
nadále	nadále
naděje	naděje
naděždy	naděždy
nadřízený	nadřízený
nadšení	nadšení
nahlásit	nahlásit
nahlášenou	nahlášenou
nahlížíme	nahlížíme
nahoru	nahoru
nahradily	nahradily
nahradí	nahradí
nahraných	nahraných
nahrazují	nahrazují
naivností	naivností
naivní	naivní
najala	najala
najde	najde
najdete	najdete
najdou	najdou
najednou	najednou
najímá	najímá
najímáním	najímáním
najít	najít
nakladatelství	nakladatelství
nakládány	nakládány
nakládání	nakládání
nakolik	nakolik
nakonec	nakonec
nakoupila	nakoupila
nakoupili	nakoupili
nakoupit	nakoupit
nakoupím	nakoupím
nakupuje	nakupuje
nakupujete	nakupujete
naletěl	naletěl
naletěla	naletěla
naletět	naletět
nalezení	nalezení
nalistujte	nalistujte
naložených	naložených
naložit	naložit
nalákat	nalákat
nalézt	nalézt
namalován	namalován
namluvte	namluvte
naměřeny	naměřeny
nanejvýš	nanejvýš
naopak	naopak
napadlo	napadlo
naplno	naplno
naplňovat	naplňovat
naplňují	naplňují
napojen	napojen
napomoci	napomoci
napomáhají	napomáhají
naposledy	naposledy
napovídá	napovídá
naprosto	naprosto
naprostým	naprostým
napsal	napsal
napsat	napsat
napsáno	napsáno
napuštěná	napuštěná
napuštění	napuštění
napájecího	napájecího
napájeno	napájeno
napájené	napájené
napáleno	napáleno
napíše	napíše
napětí	napětí
napětím	napětím
např	např
například	například
napůl	napůl
narazil	narazil
narazit	narazit
narazí	narazí
narovnávání	narovnávání
narozeninám	narozeninám
narušení	narušení
naráz	naráz
naráží	naráží
nasazení	nasazení
naservírovaný	naservírovaný
nastalé	nastalé
nastane	nastane
nastoupeném	nastoupeném
nastává	nastává
nasytit	nasytit
naturální	naturální
naučit	naučit
naučí	naučí
navazuje	navazuje
navrch	navrch
navrhli	navrhli
navrhne	navrhne
navrhnout	navrhnout
navrhované	navrhované
navrhuju	navrhuju
navrhují	navrhují
navrátil	navrátil
navzdory	navzdory
navázali	navázali
navíc	navíc
navíjecí	navíjecí
navštívenek	navštívenek
navštívili	navštívili
navštívit	navštívit
naznačuje	naznačuje
nazpátek	nazpátek
nazpět	nazpět
nazvaný	nazvaný
nazývat	nazývat
načase	načase
nařídil	nařídil
nařídit	nařídit
naše	naše
našeho	našeho
našel	našel
našem	našem
našemu	našemu
naši	naši
našich	našich
našim	našim
našimi	našimi
našla	našla
našlo	našlo
naštěstí	naštěstí
naší	naší
nažehlení	nažehlení
nebezpečná	nebezpečná
nebezpečné	nebezpečné
nebezpečných	nebezpečných
nebezpečí	nebezpečí
nebo	nebo
neboť	neboť
nebrat	nebrat
nebrání	nebrání
nebude	nebude
nebudou	nebudou
nebudu	nebudu
nebyl	nebyl
nebyla	nebyl +a
nebyli	nebyli
nebylo	nebylo
nebyly	nebyl +y
nebytové	nebytové
nebytových	nebytových
nebytovým	nebytovým
nebýt	nebýt
nebývají	nebývají
nebývale	nebývale
nebývá	nebývá
necelé	necelé
necelých	necelých
nechal	nechal
nechanský	nechanský
nechat	nechat
nechce	nechce
nechte	nechte
nechtějí	nechtějí
nechtěla	nechtěla
nechtěli	nechtěli
nechtěné	nechtěné
nechybí	nechybí
nechystá	nechystá
nechápali	nechápali
nechápu	nechápu
nedají	nedají
nedala	nedala
nedaleko	nedaleko
nedalekém	nedalekém
nedalekých	nedalekých
nedalo	nedalo
nedobrých	nedobrých
nedoceňuje	nedoceňuje
nedohodnou	nedohodnou
nedojde	nedojde
nedokáže	nedokáže
nedopatření	nedopatření
nedorazí	nedorazí
nedorozuměním	nedorozuměním
nedosahují	nedosahují
nedostal	nedostal
nedostali	nedostali
nedostatek	nedostatek
nedostatečná	nedostatečná
nedostatečné	nedostatečné
nedostatečně	nedostatečně
nedostavila	nedostavila
nedostává	nedostává
nedovedou	nedovedou
nedovoláte	nedovoláte
nedovážela	nedovážela
nedováželo	nedováželo
nedozvěděli	nedozvěděli
nedozírné	nedozírné
nedošlo	nedošlo
nedá	nedá
nedávají	nedávají
nedávno	nedávno
nedávnou	nedávnou
nedávná	nedávná
nedávné	nedávné
nedává	nedává
nedáváme	nedáváme
neděle	neděle
nedělené	nedělené
neděli	neděli
nedělá	nedělá
nedělích	nedělích
nedůležité	nedůležité
nedůvěru	nedůvěru
neefektivní	neefektivní
neexistuje	neexistuje
nefandím	nefandím
nefiremních	nefiremních
neformálními	neformálními
negativní	negativní
negativních	negativních
negativního	negativního
negativně	negativně
nehrne	nehrne
nejasná	nejasná
nejatraktivnějším	nejatraktivnějším
nejbližší	nejbližší
nejbližšího	nejbližšího
nejblíže	nejblíže
nejde	nejde
nejdražší	nejdražší
nejdéle	nejdéle
nejdříve	nejdříve
nejdůležitější	nejdůležitější
nejeden	nejeden
nejednou	nejednou
nejefektivněji	nejefektivněji
nejel	nejel
nejen	nejen
nejenže	nejenže
nejexponovanějších	nejexponovanějších
nejezdí	nejezdí
nejhorší	nejhorší
nejhorším	nejhorším
nejhůř	nejhůř
nejistotu	nejistotu
nejjednodušší	nejjednodušší
nejjednodušším	nejjednodušším
nejlepší	nejlepší
nejlepších	nejlepších
nejlevnější	nejlevnější
nejlépe	nejlépe
nejmenší	nejmenší
nejmodernějších	nejmodernějších
nejmodernějším	nejmodernějším
nejméně	nejméně
nejnadějněji	nejnadějněji
nejnaléhavěji	nejnaléhavěji
nejnižší	nejnižší
nejnovější	nejnovější
nejpozději	nejpozději
nejprve	nejprve
nejpřesvědčivějších	nejpřesvědčivějších
nejrychleji	nejrychleji
nejrychlejší	nejrychlejší
nejrůznější	nejrůznější
nejrůznějších	nejrůznějších
nejrůznějšími	nejrůznějšími
nejsilnější	nejsilnější
nejsme	nejsme
nejsnadněji	nejsnadněji
nejsou	nejsou
nejspíš	nejspíš
nejtvrdší	nejtvrdší
nejvhodnější	nejvhodnější
nejvyšší	nejvyšší
nejvyššího	nejvyššího
nejvzácnější	nejvzácnější
nejvíc	nejvíc
nejvíce	nejvíce
nejvýhodněji	nejvýhodněji
nejvýhodnější	nejvýhodnější
nejvýznamnějšího	nejvýznamnějšího
nejvýše	nejvýše
největší	největší
největších	největších
největšího	největšího
největšímu	největšímu
nejzajímavější	nejzajímavější
nejzákladnějších	nejzákladnějších
nejúspěšnější	nejúspěšnější
nejúčinnější	nejúčinnější
nejčastěji	nejčastěji
nejčernější	nejčernější
nejčistší	nejčistší
nekalá	nekalá
nekalé	nekalé
neklade	neklade
nekojit	nekojit
nekonečný	nekonečný
nekonkurujeme	nekonkurujeme
nekorektnosti	nekorektnosti
nekoupil	nekoupil
nekoupili	nekoupili
nekoupí	nekoupí
nekrytými	nekrytými
nekrást	nekrást
nekvalitní	nekvalitní
nekvalitního	nekvalitního
nekázeň	nekázeň
nekázni	nekázni
nelegální	nelegální
nelezu	nelezu
nelitoval	nelitoval
nelze	nelze
nelže	nelže
nemají	nemají
nemalé	nemalé
nemanželské	nemanželské
nemilosrdného	nemilosrdného
nemluvě	nemluvě
nemoc	nemoc
nemocenského	nemocenského
nemocenskými	nemocenskými
nemoci	nemoci
nemocnice	nemocnice
nemocnici	nemocnici
nemohl	nemohl
nemohli	nemohli
nemohly	nemohly
nemohou	nemohou
nemohu	nemohu
nemotivované	nemotivované
nemožné	nemožné
nemusí	nemusí
nemusíte	nemusíte
nemyslitelné	nemyslitelné
nemá	nemá
nemálo	nemálo
nemám	nemám
nemáme	nemáme
nemáte	nemáte
nemíní	nemíní
neměla	neměla
neměli	neměli
nemělo	nemělo
neměnně	neměnně
nemění	nemění
nemůže	nemůže
nemůžeme	nemůžeme
nemůžete	nemůžete
nenadálou	nenadálou
nenahradí	nenahradí
nenakoupili	nenakoupili
nenamaloval	nenamaloval
nenapadlo	nenapadlo
nenaplnily	nenaplnily
nenastala	nenastala
nenašla	nenašla
nenašli	nenašli
nenechat	nenechat
nenechte	nenechte
nenechá	nenechá
nenápadný	nenápadný
nenáročným	nenáročným
není	není
neobešlo	neobešlo
neobjednával	neobjednával
neobjevila	neobjevila
neobjevují	neobjevují
neobstála	neobstála
neobviňuje	neobviňuje
neobvyklým	neobvyklým
neochrání	neochrání
neodešli	neodešli
neodkladného	neodkladného
neodměňují	neodměňují
neodoláte	neodoláte
neodpovídá	neodpovídá
neohrozí	neohrozí
neohřejí	neohřejí
neokrádá	neokrádá
neomezený	neomezený
neomezit	neomezit
neoprávněné	neoprávněné
neoprávněně	neoprávněně
neorientuje	neorientuje
neorientují	neorientují
neotěhotněly	neotěhotněly
neperspektivní	neperspektivní
neplatil	neplatil
neplatí	neplatí
nepochybné	nepochybné
nepochybujeme	nepochybujeme
nepodařilo	nepodařilo
nepodléhají	nepodléhají
nepohodlných	nepohodlných
nepolemizujme	nepolemizujme
nepomysleli	nepomysleli
nepoměr	nepoměr
neponechávají	neponechávají
neposkytnul	neposkytnul
neposkytuje	neposkytuje
nepostupoval	nepostupoval
nepotěší	nepotěší
nepověří	nepověří
nepozná	nepozná
nepoznáváte	nepoznáváte
nepočítal	nepočítal
nepoškozenou	nepoškozenou
nepoškozené	nepoškozené
nepravém	nepravém
neprivatizovaných	neprivatizovaných
neprodal	neprodal
neprodané	neprodané
neprodejným	neprodejným
neprodá	neprodá
neprodělal	neprodělal
nepromítl	nepromítl
nepropadly	nepropadly
nepropočítával	nepropočítával
neprosperují	neprosperují
neprovádí	neprovádí
nepružné	nepružné
nepěstují	nepěstují
nepředstírá	nepředstírá
nepředvídané	nepředvídané
nepřekračovaly	nepřekračovaly
nepřekračuje	nepřekračuje
nepřekročí	nepřekročí
nepřekvapuje	nepřekvapuje
nepřesahuje	nepřesahuje
nepřesáhne	nepřesáhne
nepřetržité	nepřetržité
nepřetržitého	nepřetržitého
nepřetržitě	nepřetržitě
nepřežijí	nepřežijí
nepřijatelné	nepřijatelné
nepřijde	nepřijde
nepřiměřenou	nepřiměřenou
nepřipadá	nepřipadá
nepřipustila	nepřipustila
nepřímo	nepřímo
nepřímé	nepřímé
nepřímý	nepřímý
nepřítomnosti	nepřítomnosti
nepříznivou	nepříznivou
nepříznivé	nepříznivé
nepříznivých	nepříznivých
nepříznivě	nepříznivě
nepůjde	nepůjde
nepůjčují	nepůjčují
nepůvodním	nepůvodním
nerovnoměrně	nerovnoměrně
nerozcházely	nerozcházely
nerozdílnou	nerozdílnou
nerozhodl	nerozhodl
nerozumíte	nerozumíte
neručí	neručí
nervový	nervový
nervózní	nervózní
neschopné	neschopné
neschopní	neschopní
neschopných	neschopných
neschválení	neschválení
nese	nese
neseme	neseme
neseriozní	neseriozní
nesignovaná	nesignovaná
nesjízdné	nesjízdné
nesl	nesl
nesla	nesla
nesmí	nesmí
nesmírně	nesmírně
nesouhlas	nesouhlas
nesouhlasí	nesouhlasí
nesouhlasím	nesouhlasím
nesplnily	nesplnily
nesplní	nesplní
nespojí	nespojí
nespokojenost	nespokojenost
nespokojenosti	nespokojenosti
nespokojit	nespokojit
nesporně	nesporně
nespěchají	nespěchají
nestalo	nestalo
nestačil	nestačil
nestačí	nestačí
nestranného	nestranného
nestálo	nestálo
nestály	nestály
nestěžují	nestěžují
nesvědčily	nesvědčily
netají	netají
netroufám	netroufám
netrpělivě	netrpělivě
netržnímu	netržnímu
netvrdil	netvrdil
netypická	netypická
netáhne	netáhne
neudržitelná	neudržitelná
neumožňuje	neumožňuje
neumí	neumí
neupravovala	neupravovala
neurologie	neurologie
neusmívat	neusmívat
neuspěli	neuspěli
neustále	neustále
neustálý	neustálý
neuvědomují	neuvědomují
neuvěřitelné	neuvěřitelné
neužívá	neužívá
nevhodnost	nevhodnost
nevhodné	nevhodné
nevhodně	nevhodně
nevidí	nevidí
neviděl	neviděl
nevidět	nevidět
nevinu	nevinu
nevoní	nevoní
nevrátilo	nevrátilo
nevrátí	nevrátí
nevydají	nevydají
nevydražilo	nevydražilo
nevydraží	nevydraží
nevydržely	nevydržely
nevydá	nevydá
nevydávání	nevydávání
nevyhnuly	nevyhnuly
nevyjasněnost	nevyjasněnost
nevymahatelnosti	nevymahatelnosti
nevymahatelná	nevymahatelná
nevynecháte	nevynecháte
nevyplatí	nevyplatí
nevyplácel	nevyplácel
nevyplácí	nevyplácí
nevypočitatelný	nevypočitatelný
nevyrábí	nevyrábí
nevyskytovaly	nevyskytovaly
nevyužít	nevyužít
nevyzná	nevyzná
nevyzpytatelné	nevyzpytatelné
nevyzvednout	nevyzvednout
nevyčíslitelné	nevyčíslitelné
nevzala	nevzala
nevznikne	nevznikne
nevzniknou	nevzniknou
neví	neví
nevím	nevím
nevíme	nevíme
nevíte	nevíte
nevýdělečné	nevýdělečné
nevýdělečném	nevýdělečném
nevýhodou	nevýhodou
nevěnovaly	nevěnovaly
nevěřte	nevěřte
nezachází	nezachází
nezajímala	nezajímala
nezajímavé	nezajímavé
nezajímavého	nezajímavého
nezajímavých	nezajímavých
nezaměstanosti	nezaměstanosti
nezaměstnanost	nezaměstnanost
nezaměstnanosti	nezaměstnanosti
nezaměstnaných	nezaměstnaných
nezanedbatelné	nezanedbatelné
nezaplacených	nezaplacených
nezaplatil	nezaplatil
nezapomeňte	nezapomeňte
nezaváhala	nezaváhala
nezačne	nezačne
nezažil	nezažil
nezbaví	nezbaví
nezbytná	nezbytná
nezbytné	nezbytné
nezbytného	nezbytného
nezmění	nezmění
neznají	neznají
neznalost	neznalost
nezná	nezná
neznám	neznám
neznámou	neznámou
neznámého	neznámého
neznámým	neznámým
neznámými	neznámými
nezodpovídáme	nezodpovídáme
nezpožďuje	nezpožďuje
neztratil	neztratil
neztratí	neztratí
nezáleželo	nezáleželo
nezávadnosti	nezávadnosti
nezáviděníhodné	nezáviděníhodné
nezávisí	nezávisí
nezískávají	nezískávají
nezřídka	nezřídka
nezůstává	nezůstává
neúměrné	neúměrné
neúměrně	neúměrně
neúplných	neúplných
neúspěchu	neúspěchu
neúspěších	neúspěších
neúčastní	neúčastní
nečekal	nečekal
nečekaně	nečekaně
nečitelný	nečitelný
nečpí	nečpí
neřešen	neřešen
nešlo	nešlo
nich	nich
nichetzu	nichetzu
nichž	nichž
nicméně	nicméně
nijak	nijak
nikam	nikam
nikde	nikde
nikdo	nikdo
nikdy	nikdy
nikoliv	nikoliv
nikomu	nikomu
nimi	nimi
nimiž	nimiž
nimž	nimž
nippon	nippon
nitě	nitě
ničeho	ničeho
ničím	ničím
nižší	nižší
nominovaná	nominovaná
nominální	nominální
nominálních	nominálních
norma	norma
normalizaci	normalizaci
normalizovala	normalizovala
normální	normální
normálním	normálním
normálně	normálně
normě	normě
norská	norská
nosný	nosný
nosu	nosu
notebookům	notebookům
nouze	nouze
nova	nov +a
novela	novela
novelami	novelami
novelizace	novelizace
novelizaci	novelizaci
novelizovaného	novelizovaného
novin	novin
novinek	novinek
novinkou	novin +kou
novinku	novinku
novinky	novin +ky
novinkách	novinkách
novinovém	novinovém
noviny	noviny
novinách	novinách
novinář	novinář
novinářská	novinářská
novinářům	novinářům
novojičínsku	novojičínsku
novojičínské	novojičínské
novotného	novotného
novotný	novotný
novotným	novotným
novou	novou
novy	nov +y
nová	nová
nové	nové
nového	nového
novém	novém
noví	noví
nový	nový
nových	nových
novými	novými
nově	nově
nočních	nočních
nošení	nošení
nucen	nucen
nuceni	nuceni
nuceně	nuceně
nulovou	nulovou
nulové	nulové
nulový	nulový
nuly	nuly
nutno	nutno
nutnost	nutnost
nutnosti	nutnosti
nutností	nutností
nutné	nutné
nutného	nutného
nutných	nutných
nymburk	nymburk
nymburka	nymburka
nyní	nyní
nynější	nynější
nynějších	nynějších
náborovým	náborovým
nábytek	nábytek
nábytkem	nábytkem
nábytku	nábytku
nábřeží	nábřeží
nádobách	nádobách
nádraží	nádraží
náhlé	náhlé
náhoda	náhoda
náhodní	náhodní
náhodou	náhodou
náhodě	náhodě
náhrad	náhrad
náhradních	náhradních
náhrady	náhrady
nájem	nájem
nájemce	nájemce
nájemci	nájemci
nájemců	nájemců
nájemkyně	nájemkyně
nájemné	nájemné
nájemného	nájemného
nájemní	nájemní
nájemníci	nájemníci
nájemního	nájemního
nájemníka	nájemníka
nájemníkem	nájemníkem
nájemníků	nájemníků
nájmu	nájmu
náklad	náklad
nákladech	nákladech
nákladné	nákladné
nákladních	nákladních
nákladové	nákladové
nákladu	nákladu
náklady	náklady
nákladů	nákladů
náklonností	náklonností
nákup	nákup
nákupech	nákupech
nákupní	nákupní
nákupním	nákupním
nákupu	nákupu
nákupčích	nákupčích
nákupů	nákupů
náležitostmi	náležitostmi
námi	námi
námitky	námitky
náměstek	náměstek
náměstí	náměstí
nápad	nápad
nápaditým	nápaditým
nápadu	nápadu
nápady	nápady
nápisy	nápisy
náplní	náplní
náplň	náplň
nápoje	nápoje
nápojem	nápojem
nápojových	nápojových
nápojů	nápojů
nápor	nápor
náprstkově	náprstkově
národa	národa
národní	národní
národního	národního
národnímu	národnímu
národohospodáři	národohospodáři
nárok	nárok
nároky	nároky
nárokům	nárokům
náročné	náročné
náročném	náročném
náročných	náročných
náročnější	náročnější
náročnějším	náročnějším
nárůst	nárůst
následky	následky
následným	následným
následně	následně
následovat	následovat
následují	následují
následující	následující
následujících	následujících
následujícího	následujícího
následujícím	následujícím
násobné	násobné
nástroj	nástroj
nástroji	nástroji
nástrojích	nástrojích
nástupce	nástupce
nástěnné	nástěnné
nátlaku	nátlaku
návod	návod
návodu	návodu
návody	návody
návrh	návrh
návrhem	návrhem
návrhu	návrhu
návrhy	návrhy
návrhů	návrhů
návyku	návyku
návštěva	návštěv +a
návštěvnost	návštěvnost
návštěvníky	návštěvníky
návštěvníků	návštěvníků
návštěvou	návštěvou
návštěvu	návštěvu
návštěvy	návštěv +y
návštěvě	návštěvě
název	název
náznak	náznak
názor	názor
názoru	názoru
názory	názory
názorů	názorů
názvem	názvem
názvu	názvu
nářky	nářky
nízkou	nízkou
nízká	nízká
nízké	nízké
nízký	nízký
nízkým	nízkým
něco	něco
něho	něho
něhož	něhož
nějak	nějak
nějakou	nějakou
nějaká	nějaká
nějaké	nějaké
nějakém	nějakém
nějaký	nějaký
nějakých	nějakých
nějakým	nějakým
nějž	nějž
někde	někde
někdo	někdo
někdy	někdy
někoho	někoho
několik	několik
několika	několika
několikadenní	několikadenní
několikadenním	několikadenním
několikadenními	několikadenními
několikanásobný	několikanásobný
několikanásobně	několikanásobně
několikrát	několikrát
někom	někom
někomu	někomu
některá	některá
některé	některé
některého	některého
některém	některém
některý	některý
některých	některých
některým	některým
některými	některými
někteří	někteří
němci	němci
německa	němec +ka
německem	německem
německou	němec +kou
německu	německu
německá	německá
německé	německé
německého	německého
německých	německých
němu	němu
němčiny	němčiny
němčině	němčině
němž	němž
něčeho	něčeho
něčem	něčem
něčím	něčím
obav	obav
obavy	obavy
obce	obce
obchod	obchod
obchodech	obchodech
obchodem	obchodem
obchodní	obchodní
obchodních	obchodních
obchodníci	obchodníci
obchodního	obchodního
obchodník	obchodník
obchodníka	obchodní +k +a
obchodníky	obchodní +k +y
obchodníků	obchodníků
obchodníkům	obchodníkům
obchodním	obchodním
obchodními	obchodními
obchodovat	obchodovat
obchodování	obchodování
obchodu	obchodu
obchoduje	obchoduje
obchody	obchody
obchodě	obchodě
obchodů	obchodů
obchodům	obchodům
obci	obci
obcí	obcí
obdaroval	obdaroval
obdarovaný	obdarovaný
obdarovávání	obdarovávání
obdennímu	obdennímu
obdivuhodnou	obdivuhodnou
obdobnou	obdobnou
obdobná	obdobná
obdobných	obdobných
obdobným	obdobným
obdoby	obdoby
období	období
obdobím	obdobím
obdobě	obdobě
obdrželo	obdrželo
obdržení	obdržení
obec	obec
obecná	obecná
obecně	obecně
obeznámen	obeznámen
obezřetnost	obezřetnost
obezřetní	obezřetní
obezřetnými	obezřetnými
objasnění	objasnění
objednala	objednal +a
objednaly	objednal +y
objednaných	objednaných
objednat	objednat
objednávce	objednáv +ce
objednávek	objednávek
objednávku	objednávku
objednávky	objednáv +ky
objednávání	objednávání
objektech	objektech
objektivní	objektivní
objektivním	objektivním
objektů	objektů
objem	objem
objemy	objemy
objev	objev
objevil	objevil
objevili	objevili
objevily	objevily
objevit	objevit
objevuje	objevuje
objevují	objevují
objíždí	objíždí
oblast	oblast
oblastech	oblastech
oblasti	oblasti
oblastí	oblastí
oblečení	oblečení
obliba	obliba
oblibě	oblibě
obligace	obligace
oblíbené	oblíbené
obnos	obnos
obnova	obnova
obnovit	obnovit
obnově	obnově
obohacení	obohacení
obojí	obojí
obor	obor
oborech	oborech
oboru	oboru
obory	obory
oborů	oborů
obou	obou
oboustranné	oboustranné
obrat	obrat
obratem	obratem
obratu	obratu
obratů	obratů
obraz	obraz
obrazech	obrazech
obrazem	obrazem
obrazové	obrazové
obrazových	obrazových
obrazu	obrazu
obrazy	obrazy
obrazů	obrazů
obrnou	obrnou
obrně	obrně
obrovská	obrovská
obrovského	obrovského
obrovskému	obrovskému
obráběcí	obráběcí
obrábění	obrábění
obrázek	obrázek
obrázku	obrázku
obrázky	obrázky
obrázků	obrázků
obrázkům	obrázkům
obsahoval	obsahoval
obsahovat	obsahovat
obsahově	obsahově
obsahuje	obsahuje
obsahují	obsahují
obsahující	obsahující
obsazené	obsazené
obsazeném	obsazeném
obsažné	obsažné
obsluha	obsluha
obsluhou	obsluhou
obsluhovat	obsluhovat
obsluze	obsluze
obstará	obstará
obstarávají	obstarávají
obstarával	obstarával
obstál	obstál
obtížemi	obtížemi
obtížné	obtížné
obtížněji	obtížněji
obuv	obuv
obuvi	obuvi
obuvnický	obuvnický
obuvník	obuvník
obuví	obuví
obviněn	obviněn
obvodním	obvodním
obvykle	obvykle
obvyklá	obvyklá
obvyklé	obvyklé
obvyklého	obvyklého
obyvatel	obyvatel
obyvatele	obyvatele
obyvatelstva	obyvatelstva
obyvatelé	obyvatelé
obyčejné	obyčejné
obyčejný	obyčejný
obálka	obálka
obává	obává
občana	občana
občanského	občanského
občanský	občanský
občané	občané
občanů	občanů
občas	občas
občerstvení	občerstvení
oběd	oběd
obědě	obědě
oběma	oběma
obžaloba	obžaloba
obžalovací	obžalovací
obžalovaného	obžalovaného
ocas	ocas
ocel	ocel
oceli	oceli
oceláren	oceláren
oceněna	oceněna
ocenění	ocenění
oceňovat	oceňovat
oceňuje	oceňuje
ochabnul	ochabnul
ochoten	ochoten
ochotni	ochotni
ochotno	ochotno
ochotný	ochotný
ochranu	ochranu
ochrany	ochrany
ochranářská	ochranářská
ochraně	ochraně
ochraňující	ochraňující
ochutnat	ochutnat
ochutnání	ochutnání
ochutnávky	ochutnávky
ocitl	ocitl
ocitla	ocitla
ocitnout	ocitnout
odbavovaných	odbavovaných
odbor	odbor
odbornosti	odbornosti
odbornou	odbornou
odborná	odborná
odborné	odborné
odborného	odborného
odborníci	odborníci
odborník	odborník
odborníkem	odborníkem
odborníky	odborníky
odborníků	odborníků
odborný	odborný
odborných	odborných
odborně	odborně
odborové	odborové
odboru	odboru
odbyt	odbyt
odbytu	odbytu
odběratelů	odběratelů
odběru	odběru
odchodu	odchodu
odchylka	odchylka
odchází	odchází
oddech	oddech
oddělení	oddělení
oddělilo	oddělilo
odebraného	odebraného
odebrat	odebrat
odebrání	odebrání
odebírající	odebírající
odehrává	odehrává
odeslat	odeslat
odesílatele	odesílatele
odevzdaného	odevzdaného
odezdikezdismus	odezdikezdismus
odezva	odezva
odečetlo	odečetlo
odečte	odečte
odečtení	odečtení
odečíst	odečíst
odečítat	odečítat
odešlo	odešlo
odhad	odhad
odhadem	odhadem
odhadla	odhadla
odhadovali	odhadovali
odhadu	odhadu
odhlašování	odhlašování
odhodlanosti	odhodlanosti
odjezd	odjezd
odkaz	odkaz
odkazuje	odkazuje
odklad	odklad
odkladu	odkladu
odkoupení	odkoupení
odkoupením	odkoupením
odlehlost	odlehlost
odlety	odlety
odlišné	odlišné
odlišoval	odlišoval
odložit	odložit
odměna	odměna
odměňujeme	odměňujeme
odnést	odnést
odolnost	odolnost
odpadla	odpadla
odpadá	odpadá
odpisové	odpisové
odpisy	odpisy
odpoledne	odpoledne
odpolední	odpolední
odposlech	odposlech
odpoví	odpoví
odpovídající	odpovídající
odpovídal	odpovídal
odpovídala	odpovídala
odpovídali	odpovídali
odpovídat	odpovídat
odpovídá	odpovídá
odpovědi	odpovědi
odpovědnost	odpovědnost
odpovědnosti	odpovědnosti
odpovědné	odpovědné
odpovědět	odpovědět
odpovězení	odpovězení
odpověď	odpověď
odpočet	odpočet
odpočinek	odpočinek
odpočitatelné	odpočitatelné
odpočtem	odpočtem
odpočíváte	odpočíváte
odrazila	odrazil +a
odrazily	odrazil +y
odrušení	odrušení
odsouzen	odsouzen
odst	odst
odstavce	odstavce
odstraňování	odstraňování
odstup	odstup
odstupného	odstupného
odstupy	odstupy
odvedeného	odvedeného
odvodu	odvodu
odvody	odvody
odvolání	odvolání
odvoz	odvoz
odvozena	odvozena
odvádí	odvádí
odvádějí	odvádějí
odvážejí	odvážejí
odvětví	odvětví
odvětvích	odvětvích
odvětvím	odvětvím
odzkušování	odzkušování
odívání	odívání
oděvy	oděvy
oděvů	oděvů
odůvodněnost	odůvodněnost
odůvodnění	odůvodnění
oficiální	oficiální
oficiálních	oficiálních
oficiálně	oficiálně
ohlas	ohlas
ohlasy	ohlasy
ohledem	ohledem
ohledu	ohledu
ohromné	ohromné
ohrožení	ohrožení
ohrožování	ohrožování
ohrožujících	ohrožujících
ohřeje	ohřeje
okamžik	okamžik
okamžiku	okamžiku
okamžitém	okamžitém
okamžitý	okamžitý
okamžitě	okamžitě
okolnostech	okolnostech
okolnosti	okolnosti
okolností	okolností
okolních	okolních
okolo	okolo
okolí	okolí
okolím	okolím
okrajích	okrajích
okres	okres
okrese	okrese
okresech	okresech
okresní	okresní
okrouhlý	okrouhlý
okruhu	okruhu
okrádá	okrádá
okénko	okénko
olbron	olbron
oldřich	oldřich
olej	olej
oleje	oleje
olejem	olejem
olejomalba	olejomalb +a
olejomalbu	olejomalbu
olejomalby	olejomalb +y
olfen	olfen
olma	olma
olomouc	olomouc
olomouci	olomouci
olova	olova
olymp	olymp
olympská	olympská
olšanská	olšanská
omega	omega
omezená	omezená
omezeném	omezeném
omezení	omezení
omezením	omezením
omezit	omezit
omezování	omezování
omezuje	omezuje
omlouváme	omlouváme
omluví	omluví
omrzení	omrzení
omyl	omyl
omylu	omylu
oněch	oněch
opakovaný	opakovaný
opakuje	opakuje
opatovická	opatovická
opatovické	opatovické
opatrní	opatrní
opatrný	opatrný
opatření	opatření
opatřením	opatřením
opava	opava
opavsku	opavsku
opavská	opavská
opavští	opavští
operace	operace
operaci	operaci
operací	operací
operacích	operacích
operativně	operativně
operačním	operačním
operující	operující
opletalova	opletalova
opomenout	opomenout
opotřebením	opotřebením
opouštějí	opouštějí
opouštělo	opouštělo
oprav	oprav
oprava	oprav +a
opravdu	opravdu
opraven	opraven
opravenou	opravenou
opravené	opravené
opravit	opravit
opravna	opravn +a
opravny	opravn +y
opravu	opravu
opravy	oprav +y
opravě	opravě
opravňuje	opravňuje
oproti	oproti
oprávněné	oprávněné
oprávněně	oprávněně
optimisticky	optimisticky
optimální	optimální
optimálně	optimálně
opírající	opírající
opírat	opírat
opírá	opírá
opět	opět
ordinace	ordinace
ordinaci	ordinaci
ordinací	ordinací
organizace	organizace
organizaci	organizaci
organizací	organizací
organizační	organizační
organizovat	organizovat
organizována	organizována
organizování	organizování
organizuje	organizuje
organizují	organizují
orgán	orgán
orgánu	orgánu
orgány	orgány
orgánů	orgánů
orientace	orientace
orientaci	orientaci
orientačním	orientačním
orientovala	orientovala
orientovaná	orientovaná
orientuje	orientuje
originál	originál
originálem	originálem
originální	originální
orlicí	orlicí
oskar	oskar
oslizlo	oslizlo
oslovit	oslovit
osma	osma
osmdesát	osmdesát
osmdesátých	osmdesátých
osmi	osmi
osmnáct	osmnáct
osmé	osmé
osob	osob
osoba	osob +a
osobní	osobní
osobních	osobních
osobně	osobně
osobou	osobou
osobu	osobu
osoby	osob +y
osobám	osobám
osobě	osobě
ospalec	ospalec
ospalost	ospalost
ostatní	ostatní
ostatních	ostatních
ostatním	ostatním
ostatními	ostatními
ostatně	ostatně
ostrava	ostrav +a
ostravská	ostravská
ostravské	ostravské
ostravského	ostravského
ostravy	ostrav +y
ostravě	ostravě
ostrovech	ostrovech
ostružné	ostružné
ostře	ostře
ostřit	ostřit
ostřílené	ostřílené
osušení	osušení
osvobození	osvobození
osvědčení	osvědčení
osvědčila	osvědčila
osvědčilo	osvědčilo
osvědčují	osvědčují
osvěta	osvěta
osvětleny	osvětleny
osvětlení	osvětlení
osáhal	osáhal
otcem	otcem
otec	otec
oteplení	oteplení
otevírací	otevírací
otevírají	otevírají
otevírá	otevírá
otevřeli	otevřeli
otevřena	otevřen +a
otevřeno	otevřeno
otevřeny	otevřen +y
otevření	otevření
otevřením	otevřením
otevřeně	otevřeně
otevřít	otevřít
otou	otou
ottavě	ottavě
otto	otto
otázek	otázek
otázka	otáz +k +a
otázku	otázku
otázky	otáz +k +y
otěhotnění	otěhotnění
ovlivnily	ovlivnily
ovlivnit	ovlivnit
ovlivní	ovlivní
ovlivněna	ovlivněna
ovlivňované	ovlivňované
ovlivňovat	ovlivňovat
ovlivňování	ovlivňování
ovlivňuje	ovlivňuje
ovlivňují	ovlivňují
ovládat	ovládat
ovoce	ovoce
ovzduší	ovzduší
ověřenou	ověřenou
ověřené	ověřené
ověření	ověření
ověřených	ověřených
ověřovala	ověřovala
ověřování	ověřování
ověřuje	ověřuje
ovšem	ovšem
označen	označen
označeny	označeny
označení	označení
označil	označil
označit	označit
označovány	označovány
označují	označují
oznámení	oznámení
oznámit	oznámit
ozubených	ozubených
očekávají	očekávají
očekávanou	očekávanou
očekávané	očekávané
očekávanému	očekávanému
očekávaných	očekávaných
očekávat	očekávat
očekává	očekává
očekáváme	očekáváme
očima	očima
očista	očista
ošetřovat	ošetřovat
ošlapou	ošlapou
oživení	oživení
pacienta	pacienta
pacientům	pacientům
pacov	pacov
padesát	padesát
padesátiprocentní	padesátiprocentní
padla	padl +a
padlo	padlo
padly	padl +y
padělat	padělat
padělatelů	padělatelů
padělek	padělek
padělkem	padělkem
padělku	padělku
padělky	padělky
padělků	padělků
palacký	palacký
palas	palas
paliva	paliva
palác	palác
pamatovat	pamatovat
pamela	pamela
památek	památek
památkami	památkami
památkové	památkové
památku	památku
památky	památky
památkách	památkách
památkářů	památkářů
pana	pana
pane	pane
panelových	panelových
pankrác	pankrác
panorama	panorama
panuška	panuška
papírem	papírem
papírenském	papírenském
papíru	papíru
papírů	papírů
papírům	papírům
papíře	papíře
paradox	paradox
paradoxní	paradoxní
paragraf	paragraf
paragrafech	paragrafech
paragrafu	paragrafu
paragrafy	paragrafy
paralelu	paralelu
parametrech	parametrech
parametry	parametry
pardubické	pardubické
parfumerie	parfumerie
parity	parity
paritě	paritě
parkhotelu	parkhotelu
parkoviště	parkoviště
parkování	parkování
parku	parku
parlamentu	parlamentu
partiovky	partiovky
partner	partner
partnera	partner +a
partnerek	partnerek
partnerem	partnerem
partnerky	partnerky
partnerovi	partnerovi
partners	partners
partnerství	partnerství
partnery	partner +y
partnerů	partnerů
partneři	partneři
pasažérů	pasažérů
pasem	pasem
pasivní	pasivní
pasivum	pasivum
pastely	pastely
pasty	pasty
pasé	pasé
pasíva	pasíva
pasívum	pasívum
patentů	patentů
patnáct	patnáct
patnáctiletých	patnáctiletých
patra	patra
patrna	patrna
patrná	patrná
patrné	patrné
patrně	patrně
patřilo	patřilo
patřily	patřily
patřičné	patřičné
patřičných	patřičných
patří	patří
patřící	patřící
paul	paul
pauza	pauz +a
pauzy	pauz +y
paušál	paušál
pavel	pavel
pavelkova	pavelkova
pavlem	pavlem
pavláta	pavláta
pearson	pearson
pedagogicko	pedagogicko
pelhřimov	pelhřimov
pension	pension
penzi	penzi
penzion	penzion
penzionu	penzionu
penzí	penzí
peníze	peníze
peněz	peněz
penězi	penězi
peněženku	peněženku
perfektních	perfektních
perfektně	perfektně
periferie	periferie
periferní	periferní
periodickém	periodickém
perském	perském
personalistiku	personalistiku
personalistiky	personalistiky
personál	personál
personální	personální
personálním	personálním
perspektiv	perspektiv
perspektiva	perspektiva
perspektivní	perspektivní
perspektivních	perspektivních
perspektivu	perspektivu
perspektivě	perspektivě
perutková	perutková
pestrá	pestrá
peterka	peterka
petr	petr
petrem	petrem
petráková	petráková
pevnost	pevnost
pečení	pečení
pečlivě	pečlivě
phdr	phdr
phoeba	phoeba
piepenhagen	piepenhagen
pilířem	pilířem
pistolí	pistolí
piva	piva
pivo	pivo
pivovarů	pivovarů
pizzerie	pizzerie
pište	pište
pištec	pištec
placené	placené
placení	placení
placených	placených
plakát	plakát
planecon	planecon
planetových	planetových
plastiky	plastiky
plat	plat
platba	platb +a
platbami	platbami
platby	platb +y
platbě	platbě
plateb	plateb
platební	platební
platila	platil +a
platily	platil +y
platit	platit
platnost	platnost
platnosti	platnosti
platné	platné
platném	platném
platný	platný
platným	platným
platu	platu
platy	platy
platí	platí
plechová	plechová
plejáda	plejáda
plenění	plenění
plesnivého	plesnivého
plnila	plnila
plnit	plnit
plnohodnotné	plnohodnotné
plnou	plnou
plné	plné
plném	plném
plní	plní
plně	plně
plnění	plnění
ploch	ploch
plochu	plochu
plottery	plottery
plošných	plošných
pluhy	pluhy
pluhů	pluhů
plus	plus
plyne	plyne
plynu	plynu
plynule	plynule
plzeň	plzeň
plán	plán
plánech	plánech
plánem	plánem
plánovacím	plánovacím
plánovaného	plánovaného
plánovat	plánovat
plánování	plánování
plánu	plánu
plánuje	plánuje
plánů	plánů
plátce	plátce
plátcem	plátcem
plátci	plátci
plátek	plátek
plátna	plátna
plátno	plátno
plátně	plátně
pláč	pláč
pláž	pláž
pláže	pláže
pláži	pláži
pobočkové	pobočkové
pobyt	pobyt
pobytem	pobytem
pobytová	pobytová
pobytové	pobytové
pobytu	pobytu
pobytů	pobytů
pobřeží	pobřeží
pochlubili	pochlubili
pochopil	pochopil
pochopit	pochopit
pochopitelně	pochopitelně
pochopí	pochopí
pochopíme	pochopíme
pochvalují	pochvalují
pocházejí	pocházejí
pocitem	pocitem
pocity	pocity
podal	podal
podat	podat
podařilo	podařilo
podaří	podaří
podchodu	podchodu
podepsanou	podepsanou
podezření	podezření
podhodnocena	podhodnocena
podhodnoceném	podhodnoceném
podhůří	podhůří
podivem	podivem
podklady	podklady
podkladů	podkladů
podlahu	podlahu
podlahy	podlahy
podle	podle
podléhají	podléhají
podléhat	podléhat
podmínek	podmínek
podmínkami	podmínkami
podmínkou	podmín +kou
podmínky	podmín +ky
podmínkách	podmínkách
podmínkám	podmínkám
podmíněnému	podmíněnému
podnicích	podnicích
podnik	podnik
podnikají	podnikají
podnikal	podnikal
podnikat	podnikat
podnikatel	podnikatel
podnikatelce	podnikatel +ce
podnikatele	podnikatele
podnikatelem	podnikatelem
podnikateli	podnikateli
podnikatelka	podnikatel +ka
podnikatelskou	podnikatelskou
podnikatelská	podnikatelská
podnikatelské	podnikatelské
podnikatelského	podnikatelského
podnikatelský	podnikatelský
podnikatelských	podnikatelských
podnikatelskými	podnikatelskými
podnikatelé	podnikatelé
podnikatelů	podnikatelů
podnikatelům	podnikatelům
podnikem	podnikem
podnikovou	podnikovou
podnikové	podnikové
podnikového	podnikového
podnikovém	podnikovém
podnikových	podnikových
podniku	podniku
podniky	podniky
podniká	podniká
podnikání	podnikání
podnikáním	podnikáním
podnikáte	podnikáte
podniků	podniků
podnikům	podnikům
podničku	podničku
podnítila	podnítila
podnět	podnět
podobnou	podobnou
podobná	podobná
podobné	podobné
podobní	podobní
podobný	podobný
podobných	podobných
podobně	podobně
podobě	podobě
podpatek	podpatek
podpatků	podpatků
podpisu	podpisu
podplácení	podplácení
podpora	podpor +a
podporami	podporami
podporovaná	podporovaná
podporovat	podporovat
podporována	podporována
podporu	podporu
podporujících	podporujících
podpory	podpor +y
podpořen	podpořen
podpůrné	podpůrné
podraz	podraz
podrazit	podrazit
podraží	podraží
podrobnostech	podrobnostech
podrobném	podrobném
podrobný	podrobný
podrážek	podrážek
podrážkou	podrážkou
podstata	podstat +a
podstatnou	podstatnou
podstatné	podstatné
podstatným	podstatným
podstatně	podstatně
podstatnějším	podstatnějším
podstaty	podstat +y
podtrženo	podtrženo
podvodné	podvodné
podvodníků	podvodníků
podvojného	podvojného
podvyživenou	podvyživenou
podvědomí	podvědomí
podzim	podzim
podzimu	podzimu
podáno	podáno
podání	podání
podávat	podávat
podíl	podíl
podílel	podílel
podílem	podílem
podílet	podílet
podílu	podílu
podílí	podílí
podívejte	podívejte
poděbrady	poděbrady
podělí	podělí
podřízeny	podřízeny
podřízené	podřízené
podřízenými	podřízenými
pogress	pogress
pohlcen	pohlcen
pohled	pohled
pohledu	pohledu
pohledávek	pohledávek
pohledávku	pohledávku
pohledávky	pohledávky
pohledávkách	pohledávkách
pohledávkám	pohledávkám
pohlídat	pohlídat
pohoda	pohoda
pohodou	pohodou
pohodu	pohodu
pohodě	pohodě
pohonných	pohonných
pohostinností	pohostinností
pohotové	pohotové
pohořela	pohořela
pohrdlivě	pohrdlivě
pohyb	pohyb
pohybovala	pohybovala
pohybu	pohybu
pohybuje	pohybuje
pohybují	pohybují
pohádkový	pohádkový
pojednávací	pojednávací
pojednávají	pojednávají
pojednávající	pojednávající
pojednává	pojednává
pojetím	pojetím
pojistit	pojistit
pojistnou	pojistnou
pojistné	pojistné
pojistného	pojistného
pojistném	pojistném
pojistným	pojistným
pojistíme	pojistíme
pojištěn	pojištěn
pojištěna	pojištěna
pojištěná	pojištěná
pojištění	pojištění
pojištěním	pojištěním
pojištěný	pojištěný
pojišťovací	pojišťovací
pojišťovna	pojišťovn +a
pojišťovnami	pojišťovnami
pojišťovnictví	pojišťovnictví
pojišťovnou	pojišťovnou
pojišťovny	pojišťovn +y
pojišťovnách	pojišťovnách
pojišťovně	pojišťovně
pojmem	pojmem
pojmenování	pojmenování
pojmů	pojmů
pokladen	pokladen
pokladna	pokladn +a
pokladny	pokladn +y
pokladních	pokladních
pokles	pokles
poklesem	poklesem
poklesl	poklesl
pokoj	pokoj
pokoje	pokoje
pokojích	pokojích
pokoukání	pokoukání
pokoutním	pokoutním
pokračovalo	pokračovalo
pokračovat	pokračovat
pokračování	pokračování
pokračuje	pokračuje
pokračujeme	pokračujeme
pokračující	pokračující
pokrytá	pokrytá
pokrytí	pokrytí
pokrýt	pokrýt
pokud	pokud
pokusme	pokusme
pokuste	pokuste
pokusu	pokusu
pokusy	pokusy
pokutována	pokutována
poldovka	poldovka
polemiku	polemiku
polevil	polevil
police	police
policejního	policejního
policie	policie
politice	politi +ce
politické	politické
politického	politického
politika	politi +k +a
politiku	politiku
politiky	politi +k +y
poloha	poloh +a
polohy	poloh +y
pololetí	pololetí
polopenze	polopenze
polopenzi	polopenzi
poloprázdná	poloprázdná
polovic	polovic
polovina	polovin +a
polovinu	polovinu
poloviny	polovin +y
polovině	polovině
poloviční	poloviční
polozamrzlé	polozamrzlé
položek	položek
položenou	položenou
položit	položit
položka	polož +k +a
položkou	polož +kou
položky	polož +k +y
polskem	polskem
polsku	polsku
polských	polských
polák	polák
polštář	polštář
polštáři	polštáři
polštářů	polštářů
pomaleji	pomaleji
pomalejší	pomalejší
pomalu	pomalu
pomoc	pomoc
pomoci	pomoci
pomocník	pomocník
pomocníka	pomocníka
pomocníkem	pomocníkem
pomocný	pomocný
pomocí	pomocí
pomohla	pomohla
pomohlo	pomohlo
pomohou	pomohou
pomyslel	pomyslel
pomyšlení	pomyšlení
pomáhá	pomáhá
pomáhám	pomáhám
poměr	poměr
poměrech	poměrech
poměrnou	poměrnou
poměrným	poměrným
poměrně	poměrně
poměru	poměru
poměry	poměry
pomůcky	pomůcky
pondělky	pondělky
pondělí	pondělí
ponechají	ponechají
ponechali	ponechali
poněkud	poněkud
poodhalil	poodhalil
popis	popis
popisky	popisky
popisovali	popisovali
popisuje	popisuje
poplatek	poplatek
poplatků	poplatků
poplatný	poplatný
poplést	poplést
poprvé	poprvé
popsal	popsal
popsat	popsat
poptávce	poptáv +ce
poptávka	poptáv +k +a
poptávkou	poptáv +kou
poptávku	poptávku
poptávky	poptáv +k +y
popud	popud
populární	populární
popředí	popředí
porada	porada
poradce	poradce
poradců	poradců
poradenskou	poradenskou
poradenské	poradenské
poradenství	poradenství
poradenstvím	poradenstvím
poradil	poradil
poradit	poradit
poradna	poradna
poradnu	poradnu
poradu	poradu
poradí	poradí
poraďte	poraďte
porcelánu	porcelánu
porci	porci
poroste	poroste
porouchané	porouchané
porouchaný	porouchaný
poruch	poruch
poruchy	poruchy
porušení	porušení
porušování	porušování
porušuje	porušuje
porušují	porušují
poschodí	poschodí
poshovění	poshovění
posiluje	posiluje
posily	posily
poskytlo	poskytlo
poskytnout	poskytnout
poskytnuta	poskytnuta
poskytnuto	poskytnuto
poskytnutá	poskytnutá
poskytnutím	poskytnutím
poskytnutých	poskytnutých
poskytované	poskytované
poskytovaným	poskytovaným
poskytovat	poskytovat
poskytován	poskytován
poskytováním	poskytováním
poskytuje	poskytuje
poskytují	poskytují
poslal	poslal
poslaly	poslaly
poslancům	poslancům
poslech	poslech
poslední	poslední
posledních	posledních
posledního	posledního
poslouží	poslouží
posoudit	posoudit
posouzeny	posouzeny
posouzení	posouzení
pospíchal	pospíchal
posse	posse
postaven	postaven
postavení	postavení
postavených	postavených
posteli	posteli
postelov	postelov
postgraduální	postgraduální
postihla	postihla
postihnout	postihnout
postižených	postižených
postrádali	postrádali
postrádá	postrádá
postrádám	postrádám
postup	postup
postupech	postupech
postupem	postupem
postupné	postupné
postupnému	postupnému
postupným	postupným
postupně	postupně
postupovala	postupovala
postupovat	postupovat
postupu	postupu
postupy	postupy
postupů	postupů
posudek	posudek
posudkem	posudkem
posudky	posudky
posudků	posudků
posun	posun
posunutím	posunutím
posuzovat	posuzovat
posuzována	posuzována
posuzování	posuzování
posuzuje	posuzuje
posílením	posílením
potahové	potahové
potažmo	potažmo
potenciální	potenciální
potenciálu	potenciálu
potká	potká
potom	potom
potravin	potravin
potravinami	potravinami
potraviny	potraviny
potravinách	potravinách
potravináři	potravináři
potravinářskou	potravinářskou
potravinářských	potravinářských
potrápil	potrápil
potvrdil	potvrdil
potvrdila	potvrdila
potvrdili	potvrdili
potvrdilo	potvrdilo
potvrdit	potvrdit
potvrzení	potvrzení
potvrzovat	potvrzovat
potvrzuje	potvrzuje
potvrzuji	potvrzuji
potvrzují	potvrzují
potápěčský	potápěčský
poté	poté
potížemi	potížemi
potížích	potížích
potěšitelné	potěšitelné
potěšující	potěšující
potřeb	potřeb
potřeba	potřeb +a
potřebami	potřebami
potřebnou	potřebnou
potřebné	potřebné
potřeboval	potřeboval
potřebu	potřebu
potřebuje	potřebuje
potřebujeme	potřebujeme
potřebujete	potřebujete
potřebuješ	potřebuješ
potřebují	potřebují
potřeby	potřeb +y
potřebám	potřebám
pouhých	pouhých
poukaz	poukaz
poukazovaly	poukazovaly
poukazů	poukazů
poukázky	poukázky
poutačů	poutačů
pouze	pouze
poučení	poučení
poučili	poučili
pouštět	pouštět
použijete	použijete
použila	použila
použit	použit
použití	použití
použitých	použitých
použít	použít
používají	používají
používající	používající
používané	používané
používat	používat
používá	používá
používáme	používáme
používání	používání
povahu	povahu
považovat	považovat
považováno	považováno
považuje	považuje
povinen	povinen
povinnost	povinnost
povinnosti	povinnosti
povinnostmi	povinnostmi
povinností	povinností
povinnému	povinnému
povinně	povinně
povolen	povolen
povolené	povolené
povolení	povolení
povolit	povolit
povoluje	povoluje
povolání	povolání
povrchová	povrchová
povrchového	povrchového
povrchů	povrchů
povzbudit	povzbudit
poválečném	poválečném
povědomí	povědomí
pověst	pověst
pověřen	pověřen
pozadí	pozadí
pozdní	pozdní
pozdních	pozdních
pozdě	pozdě
později	později
pozdější	pozdější
pozdějších	pozdějších
pozemní	pozemní
pozic	pozic
pozice	pozice
pozici	pozici
pozitivní	pozitivní
pozitivních	pozitivních
pozitivně	pozitivně
pozn	pozn
poznat	poznat
poznatkem	poznatkem
poznatky	poznatky
pozná	pozná
poznáním	poznáním
pozornost	pozornost
pozornosti	pozornosti
pozorností	pozorností
pozorně	pozorně
pozorování	pozorování
pozvali	pozvali
pozvánek	pozvánek
pozvání	pozvání
počasí	počasí
počestní	počestní
počet	počet
počtem	počtem
počtu	počtu
počáteční	počáteční
počátečních	počátečních
počátečním	počátečním
počátkem	počátkem
počátku	počátku
počínaje	počínaje
počítadlo	počítadlo
počítala	počítal +a
počítaly	počítal +y
počítat	počítat
počítač	počítač
počítače	počítače
počítačem	počítačem
počítači	počítači
počítačové	počítačové
počítačových	počítačových
počítačích	počítačích
počítačů	počítačů
počítačům	počítačům
počítejme	počítejme
počítá	počítá
pořizovací	pořizovací
pořizují	pořizují
pořád	pořád
pořádají	pořádají
pořádek	pořádek
pořádně	pořádně
pořádá	pořádá
pořádání	pořádání
pořídit	pořídit
pořídí	pořídí
pořídíte	pořídíte
pořízení	pořízení
poříčí	poříčí
poškodil	poškodil
poškozené	poškozené
poškozením	poškozením
poškozených	poškozených
poškozuje	poškozuje
pošle	pošle
pošt	pošt
pošta	pošt +a
poštami	poštami
poštou	poštou
poštovní	poštovní
poštovních	poštovních
poštu	poštu
pošty	pošt +y
poště	poště
požadavkem	požadavkem
požadavky	požadavky
požadavků	požadavků
požadavkům	požadavkům
požadovanou	požadovanou
požadované	požadované
požadovaných	požadovaných
požadovat	požadovat
požadují	požadují
požádala	požádal +a
požádali	požádali
požádalo	požádalo
požádaly	požádal +y
požádat	požádat
požádání	požádání
pracantem	pracantem
prachatice	prachatice
pracnost	pracnost
pracoval	pracoval
pracovala	pracovala
pracovali	pracovali
pracovat	pracovat
pracovišti	pracovišti
pracoviště	pracoviště
pracovnice	pracovnice
pracovní	pracovní
pracovních	pracovních
pracovníci	pracovníci
pracovního	pracovního
pracovník	pracovník
pracovníka	pracovní +k +a
pracovníkovi	pracovníkovi
pracovníky	pracovní +k +y
pracovníků	pracovníků
pracovníkům	pracovníkům
pracovními	pracovními
pracuje	pracuje
pracují	pracují
prací	prací
praga	praga
pragmatický	pragmatický
pragodata	pragodata
praha	prah +a
prahou	prahou
prahu	prahu
prahy	prah +y
prajzler	prajzler
prakticky	prakticky
praktický	praktický
praktikami	praktikami
praktikantům	praktikantům
pramen	pramen
prasátka	prasátka
pratt	pratt
pravda	pravda
pravdomluvno	pravdomluvno
pravdu	pravdu
pravděpodobnost	pravděpodobnost
pravděpodobnosti	pravděpodobnosti
pravděpodobné	pravděpodobné
pravděpodobného	pravděpodobného
pravděpodobný	pravděpodobný
pravděpodobně	pravděpodobně
pravděpodobnější	pravděpodobnější
pravidel	pravidel
pravidelných	pravidelných
pravidelně	pravidelně
pravidla	pravidla
pravidlem	pravidlem
pravidlo	pravidlo
pravidlům	pravidlům
pravilo	pravilo
pravomocí	pravomocí
pravost	pravost
pravé	pravé
pravý	pravý
praxe	praxe
praxi	praxi
praxí	praxí
praze	praze
pražská	pražská
pražské	pražské
pražského	pražského
pražském	pražském
pražský	pražský
pražských	pražských
prefabrikátů	prefabrikátů
preference	preference
preferovat	preferovat
prefy	prefy
preisler	preisler
premieren	premieren
premií	premií
press	press
prevence	prevence
preventivně	preventivně
prezentaci	prezentaci
prezentacích	prezentacích
prezentačním	prezentačním
prezentovat	prezentovat
prezentována	prezentována
prezident	prezident
prezidentů	prezidentů
prievidza	prievidza
princip	princip
priorit	priorit
prioritní	prioritní
privatizace	privatizace
privatizaci	privatizaci
privatizační	privatizační
privatizačního	privatizačního
privatizovány	privatizovány
probere	probere
problematice	problemati +ce
problematika	problemati +ka
problematizují	problematizují
problém	problém
problémových	problémových
problémy	problémy
problémů	problémů
probuzení	probuzení
probíhají	probíhají
probíhala	probíhala
probíhalo	probíhalo
probíhá	probíhá
proběhla	proběhl +a
proběhly	proběhl +y
procent	procent
procenta	procent +a
procentní	procentní
procentním	procentním
procentními	procentními
procento	procento
procenty	procent +y
procentům	procentům
procesy	procesy
procházejících	procházejících
prodají	prodají
prodal	prodal
prodat	prodat
prodavače	prodavače
prodavaček	prodavaček
prodej	prodej
prodejce	prodejce
prodejci	prodejci
prodeje	prodeje
prodejem	prodejem
prodejen	prodejen
prodeji	prodeji
prodejna	prodejn +a
prodejnost	prodejnost
prodejny	prodejn +y
prodejná	prodejná
prodejnách	prodejnách
prodejní	prodejní
prodejních	prodejních
prodejního	prodejního
prodejním	prodejním
prodejný	prodejný
prodejným	prodejným
prodejně	prodejně
prodloužením	prodloužením
prodražil	prodražil
prodražovalo	prodražovalo
producenta	producenta
produkce	produkce
produkcí	produkcí
produkt	produkt
produktech	produktech
produktivity	produktivity
produktivního	produktivního
produktu	produktu
produkty	produkty
produktů	produktů
prodá	prodá
prodán	prodán
prodána	prodána
prodáno	prodáno
prodávají	prodávají
prodávající	prodávající
prodával	prodával
prodávali	prodávali
prodávaných	prodávaných
prodávat	prodávat
prodává	prodává
prodávám	prodávám
prodáváme	prodáváme
prodělat	prodělat
prodělá	prodělá
proexportní	proexportní
profese	profese
profesemi	profesemi
profesi	profesi
profesionalita	profesionalita
profesionální	profesionální
profesionálních	profesionálních
profesionálové	profesionálové
profesionály	profesionály
profesní	profesní
profesora	profesor +a
profesory	profesor +y
profess	profess
profesí	profesí
profesích	profesích
profilem	profilem
profilu	profilu
profit	profit
profitovat	profitovat
profitu	profitu
prog	prog
prognóze	prognóze
prognózujeme	prognózujeme
program	program
programech	programech
programem	programem
programovatelný	programovatelný
programové	programové
programového	programového
programu	programu
programy	programy
programátor	programátor
programů	programů
progres	progres
progress	progress
prohloubení	prohloubení
prohlubování	prohlubování
prohlásil	prohlásil
prohlásit	prohlásit
prohlásí	prohlásí
prohlédnout	prohlédnout
prohrál	prohrál
projde	projde
projdou	projdou
projednat	projednat
projednávání	projednávání
projekt	projekt
projekty	projekty
projet	projet
projevilo	projevilo
projevit	projevit
projevuje	projevuje
projevují	projevují
projeví	projeví
prokazuje	prokazuje
prokeš	prokeš
proklamativně	proklamativně
prokázala	prokázal +a
prokázaly	prokázal +y
prokázat	prokázat
prokázána	prokázána
proležíte	proležíte
promlčeným	promlčeným
promptními	promptními
promítnout	promítnout
promítnut	promítnut
pronajaté	pronajaté
pronajimatel	pronajimatel
pronajimatele	pronajimatele
pronajímá	pronajímá
pronikání	pronikání
pronto	pronto
pronájem	pronájem
propadnutí	propadnutí
propagační	propagační
propagačními	propagačními
propagovaní	propagovaní
propagující	propagující
propastné	propastné
propašováno	propašováno
proplatí	proplatí
propojeny	propojeny
propojení	propojení
propojováním	propojováním
propouštění	propouštění
propočte	propočte
propočítávat	propočítávat
propustil	propustil
propásl	propásl
prorazit	prorazit
proroctví	proroctví
prosadila	prosadila
prosadili	prosadili
prosadit	prosadit
prosazoval	prosazoval
prosazuje	prosazuje
prosince	prosince
prosinci	prosinci
prosincová	prosincová
prospekt	prospekt
prospekty	prospekty
prosperitu	prosperitu
prosperity	prosperity
prosperitě	prosperitě
prosperovala	prosperovala
prosperujeme	prosperujeme
prosperující	prosperující
prospěch	prospěch
prospěla	prospěla
prostavěných	prostavěných
prostor	prostor
prostorově	prostorově
prostoru	prostoru
prostory	prostory
prostorům	prostorům
prostudování	prostudování
prostě	prostě
prostředcích	prostředcích
prostředky	prostředky
prostředků	prostředků
prostřednictvím	prostřednictvím
prostředí	prostředí
prostředím	prostředím
prosí	prosí
proteče	proteče
proti	proti
protikladně	protikladně
protisluneční	protisluneční
protislužby	protislužby
protislužbě	protislužbě
protiváha	protiváha
proto	proto
protokolem	protokolem
prototypů	prototypů
protože	protože
protrade	protrade
protrženého	protrženého
protáhnout	protáhnout
proud	proud
proudu	proudu
proužky	proužky
provedena	proveden +a
provedeny	proveden +y
provedení	provedení
provenience	provenience
proviant	proviant
provincie	provincie
provincií	provincií
provize	provize
provoz	provoz
provozních	provozních
provozovat	provozovat
provozovatelé	provozovatelé
provozovny	provozovny
provozovnách	provozovnách
provozovně	provozovně
provozování	provozování
provozu	provozu
provozuje	provozuje
provozuschopném	provozuschopném
provádí	provádí
provádějí	provádějí
prováděl	prováděl
provádění	provádění
prováděných	prováděných
provázena	provázena
provést	provést
prověřují	prověřují
prozatím	prozatím
prozkoumal	prozkoumal
prozradil	prozradil
proč	proč
proškolili	proškolili
prošlápnuté	prošlápnuté
prožrané	prožrané
prožívají	prožívají
prudce	prudce
prudší	prudší
pružnosti	pružnosti
pružnější	pružnější
prvcích	prvcích
prvek	prvek
prvenství	prvenství
prvky	prvky
první	první
prvních	prvních
prvního	prvního
prvním	prvním
prvními	prvními
prvně	prvně
prvopočátku	prvopočátku
prvotních	prvotních
prvotřídní	prvotřídní
prvořadým	prvořadým
prvé	prvé
pryž	pryž
práce	práce
práci	práci
prádelní	prádelní
práv	práv
práva	práva
právem	právem
právnických	právnických
právní	právní
právních	právních
právníci	právníci
právního	právního
právník	právník
právním	právním
právo	právo
právě	právě
prázdnin	prázdnin
prémie	prémie
prémii	prémii
prémií	prémií
prémiích	prémiích
pršala	pršala
průběhu	průběhu
průběžné	průběžné
průběžného	průběžného
průběžně	průběžně
průhlednější	průhlednější
průkazu	průkazu
průmysl	průmysl
průmyslníci	průmyslníci
průmyslová	průmyslová
průmyslové	průmyslové
průmyslových	průmyslových
průmyslovým	průmyslovým
průmyslově	průmyslově
průmyslu	průmyslu
průměr	průměr
průměrná	průměrná
průměrné	průměrné
průměrný	průměrný
průměrných	průměrných
průměrným	průměrným
průměrně	průměrně
průměru	průměru
průsmyky	průsmyky
průtok	průtok
průvodním	průvodním
průzkum	průzkum
psací	psací
psali	psali
psaného	psaného
psem	psem
pseudoživnost	pseudoživnost
psychodiagnostické	psychodiagnostické
psychologem	psychologem
psychologicky	psychologicky
psychologická	psychologická
psychologické	psychologické
psychologických	psychologických
psychologickým	psychologickým
psychologie	psychologie
psími	psími
ptejme	ptejme
ptát	ptát
ptáte	ptáte
publikace	publikace
publikaci	publikaci
publikován	publikován
publikovány	publikovány
pudla	pudla
pultík	pultík
pultů	pultů
punc	punc
purkyněho	purkyněho
pustí	pustí
putováním	putováním
pučálka	pučálka
puštěná	puštěná
pytel	pytel
pádem	pádem
pánové	pánové
pánskou	pánskou
pánské	pánské
pánvích	pánvích
páry	páry
pátek	pátek
pátku	pátku
pátý	pátý
pécéčky	pécéčky
péče	péče
péči	péči
pírek	pírek
písemnou	písemnou
písemné	písemné
písmen	písmen
píše	píše
píšou	píšou
pěkné	pěkné
pěkný	pěkný
pěkných	pěkných
pěně	pěně
pěst	pěst
pětadvacet	pětadvacet
pěti	pěti
pětiletou	pětiletou
pětilůžkových	pětilůžkových
pětinu	pětinu
pětiprocentní	pětiprocentní
přebytky	přebytky
přece	přece
přechod	přechod
přechodem	přechodem
přechodu	přechodu
přecházejí	přecházejí
přechází	přechází
před	před
předají	předají
předala	předala
předali	předali
předané	předané
předběžnou	předběžnou
předběžných	předběžných
předchozí	předchozí
předchozích	předchozích
předcházel	předcházel
předcházet	předcházet
předem	předem
předepsanou	předepsanou
předepsané	předepsané
předepíše	předepíše
především	především
předimenzována	předimenzována
předkládat	předkládat
předkládá	předkládá
předkládání	předkládání
předkupního	předkupního
předložen	předložen
předložil	předložil
předložila	předložila
předložili	předložili
předložit	předložit
předloží	předloží
předmět	předmět
předmětem	předmětem
předmětu	předmětu
předměty	předměty
předmětů	předmětů
přednost	přednost
přednosta	přednosta
přednostem	přednostem
přednostní	přednostní
přední	přední
předních	předních
předpis	předpis
předpisem	předpisem
předpisy	předpisy
předpisů	předpisů
předpoklad	předpoklad
předpokladem	předpokladem
předpokladu	předpokladu
předpoklady	předpoklady
předpokladů	předpokladů
předpokládal	předpokládal
předpokládané	předpokládané
předpokládaného	předpokládaného
předpokládat	předpokládat
předpokládá	předpokládá
předpokládám	předpokládám
předpovědět	předpovědět
předseda	předseda
představ	představ
představit	představit
představitel	představitel
představitele	představitele
představiteli	představiteli
představitelé	představitelé
představitelů	představitelů
představou	představou
představoval	představoval
představovaný	představovaný
představovat	představovat
představu	představu
představuje	představuje
představujeme	představujeme
představují	představují
představy	představy
představách	představách
předtím	předtím
předány	předány
předání	předání
předávat	předávat
přehazování	přehazování
přehled	přehled
přehledné	přehledné
přehledu	přehledu
přehledů	přehledů
přehlédnout	přehlédnout
přehlídka	přehlídka
přehodnotili	přehodnotili
přejde	přejde
překladem	překladem
překlady	překlady
překlenovací	překlenovací
překonat	překonat
překonání	překonání
překonávání	překonávání
překročit	překročit
překrvenými	překrvenými
překrýt	překrýt
překupníci	překupníci
překupníků	překupníků
překupníkům	překupníkům
překvapen	překvapen
překvapení	překvapení
překvapila	překvapila
překvapilo	překvapilo
překvapivého	překvapivého
přelomu	přelomu
přelouče	přelouče
přemisťují	přemisťují
přemyslovců	přemyslovců
přemíra	přemíra
přemírou	přemírou
přemístění	přemístění
přemýšlivější	přemýšlivější
přeměny	přeměny
přeměně	přeměně
přeměřování	přeměřování
přenosné	přenosné
přepeře	přepeře
přepravců	přepravců
přepravní	přepravní
přepravované	přepravované
přepravovat	přepravovat
přepravují	přepravují
přepravy	přepravy
přepravě	přepravě
přepážky	přepážky
přepínají	přepínají
přerostl	přerostl
přerozdělení	přerozdělení
přerozdělování	přerozdělování
přes	přes
přesahují	přesahují
přesnosti	přesnosti
přesnou	přesnou
přesné	přesné
přesný	přesný
přesně	přesně
přespříliš	přespříliš
přestal	přestal
přestalo	přestalo
přesto	přesto
přestože	přestože
přestupní	přestupní
přestávek	přestávek
přestávka	přestáv +k +a
přestávku	přestávku
přestávky	přestáv +k +y
přesunout	přesunout
přesvědčen	přesvědčen
přesvědčeni	přesvědčeni
přesvědčení	přesvědčení
přesvědčil	přesvědčil
přesvědčila	přesvědčila
přesvědčili	přesvědčili
přesvědčit	přesvědčit
přesvědčivě	přesvědčivě
přesvědčují	přesvědčují
přesvědčí	přesvědčí
přesčas	přesčas
přetahování	přetahování
přetlak	přetlak
převaha	převah +a
převahu	převahu
převahy	převah +y
převažují	převažují
převedl	převedl
převis	převis
převisu	převisu
převodu	převodu
převyšuje	převyšuje
převzít	převzít
převážně	převážně
převést	převést
přezkoušení	přezkoušení
přezkušovat	přezkušovat
přezouvat	přezouvat
přeček	přeček
přečkaly	přečkaly
přečtení	přečtení
přečtěte	přečtěte
přečíst	přečíst
přeřazování	přeřazování
přeškolení	přeškolení
přibližně	přibližně
přibližuje	přibližuje
přiblížit	přiblížit
přibylo	přibylo
přidané	přidané
přidává	přidává
přihlaste	přihlaste
přihlašovatel	přihlašovatel
přihlašování	přihlašování
přihlásilo	přihlásilo
přihlášek	přihlášek
přihlášení	přihlášení
přihláška	přihláš +k +a
přihlášku	přihlášku
přihlášky	přihláš +k +y
přihlížet	přihlížet
přihlíží	přihlíží
přijali	přijali
přijat	přijat
přijatelnou	přijatelnou
přijatelné	přijatelné
přijatelných	přijatelných
přijatá	přijatá
přijde	přijde
přijel	přijel
přijetí	přijetí
přijetím	přijetím
přijmout	přijmout
přijímací	přijímací
přijímání	přijímání
přijít	přijít
přiložit	přiložit
přilákal	přilákal
přilákat	přilákat
přinejmenším	přinejmenším
přinesl	přinesl
přinesla	přinesla
přinesli	přinesli
přineslo	přineslo
přinášejí	přinášejí
přináší	přináší
přinášíme	přinášíme
přinést	přinést
přiotrávených	přiotrávených
připadnou	připadnou
připadá	připadá
připojistit	připojistit
připojištěna	připojištěna
připojištění	připojištění
připomenout	připomenout
připomínající	připomínající
připomínce	připomínce
připomínek	připomínek
připomíná	připomíná
připomínám	připomínám
připočteme	připočteme
připraven	připraven
připravena	připraven +a
připraveni	připraveni
připravenost	připravenost
připravenosti	připravenosti
připraveny	připraven +y
připravená	připravená
připravené	připravené
připravil	připravil
připravila	připravila
připravit	připravit
připravované	připravované
připravovaném	připravovaném
připravovat	připravovat
připravuje	připravuje
připraví	připraví
připustíte	připustíte
přirážkou	přirážkou
přirážku	přirážku
přispívají	přispívají
přispívat	přispívat
přispívá	přispívá
přispělo	přispělo
přispět	přispět
přistupovaly	přistupovaly
přistupovat	přistupovat
přistupují	přistupují
přistál	přistál
přitažlivosti	přitažlivosti
přitom	přitom
přituhne	přituhne
přivezu	přivezu
přivolením	přivolením
přivydělávat	přivydělávat
přivítají	přivítají
přiznala	přiznala
přiznání	přiznání
přizpůsobila	přizpůsobil +a
přizpůsobili	přizpůsobili
přizpůsobily	přizpůsobil +y
přizpůsobuje	přizpůsobuje
přičemž	přičemž
přičte	přičte
přišel	přišel
přišla	přišl +a
přišli	přišli
přišlo	přišlo
přišly	přišl +y
přání	přání
přáním	přáním
přát	přát
přáteli	přáteli
příbuzenstvím	příbuzenstvím
příbuznými	příbuznými
příběh	příběh
příběhy	příběhy
příchodem	příchodem
příchodu	příchodu
příjemcům	příjemcům
příjemně	příjemně
příjezd	příjezd
příjmem	příjmem
příjmově	příjmově
příjmu	příjmu
příjmy	příjmy
příjmů	příjmů
příklad	příklad
příkladem	příkladem
příkladu	příkladu
příklady	příklady
příkladů	příkladů
příkopech	příkopech
příkrém	příkrém
příletu	příletu
příležitost	příležitost
příležitosti	příležitosti
příležitostné	příležitostné
příležitostí	příležitostí
přílivem	přílivem
příliš	příliš
přílišnou	přílišnou
příloha	příloha
přílohu	přílohu
příloze	příloze
přímo	přímo
přímou	přímou
přímé	přímé
přímý	přímý
příp	příp
případ	případ
případech	případech
případnou	případnou
případná	případná
případné	případné
případném	případném
případných	případných
případně	případně
případu	případu
případy	případy
případě	případě
případů	případů
přípitek	přípitek
příplatek	příplatek
příprav	příprav
příprava	příprava
přípravky	přípravky
přípravu	přípravu
přípustného	přípustného
přírodní	přírodní
přírodou	přírodou
příručka	příruč +k +a
příručky	příruč +k +y
příslibu	příslibu
příslušenství	příslušenství
příslušenstvím	příslušenstvím
příslušnou	příslušnou
příslušná	příslušná
příslušné	příslušné
příslušného	příslušného
příslušný	příslušný
příslušných	příslušných
příslušným	příslušným
přísluší	přísluší
přísná	přísná
přísně	přísně
příspěvek	příspěvek
příspěvku	příspěvku
příspěvků	příspěvků
přístroje	přístroje
přístrojů	přístrojů
přístup	přístup
přístupu	přístupu
přístupy	přístupy
přísun	přísun
přísunu	přísunu
přítomností	přítomností
příznačné	příznačné
příznivá	příznivá
příznivého	příznivého
příznivě	příznivě
příznivější	příznivější
příčinách	příčinách
příštipek	příštipek
příští	příští
příštího	příštího
příštím	příštím
půdu	půdu
půjde	půjde
půjdu	půjdu
půjček	půjček
půjčka	půjč +k +a
půjčky	půjč +k +y
půjčovat	půjčovat
půjčovna	půjčovna
půlené	půlené
půlhodinku	půlhodinku
působení	působení
působit	působit
působnosti	působnosti
působí	působí
působící	působící
působících	působících
původní	původní
původního	původního
původním	původním
původně	původně
původu	původu
quebeckých	quebeckých
québec	québec
québecké	québecké
québeku	québeku
rabín	rabín
racio	racio
racionalitou	racionalitou
racionalitu	racionalitu
racionalizace	racionalizace
rada	rad +a
radim	radim
radimský	radimský
radiofrekvenční	radiofrekvenční
radiokomunikací	radiokomunikací
radiátory	radiátory
radnici	radnici
radno	radno
radostné	radostné
radostnější	radostnější
radovánky	radovánky
radoň	radoň
radu	radu
rady	rad +y
radí	radí
radě	radě
raději	raději
rakousko	rakousko
rakousku	rakousku
ramzové	ramzové
raný	raný
rapid	rapid
raszkovi	raszkovi
razí	razí
razítko	razítko
reagoval	reagoval
reagovala	reagovala
reagovat	reagovat
reagování	reagování
realistické	realistické
realitních	realitních
realizace	realizace
realizátorem	realizátorem
rebeky	rebeky
recepcí	recepcí
recept	recept
recepty	recepty
recidivista	recidivista
recipročně	recipročně
redakce	redakce
redaktora	redaktora
redaktorka	redaktorka
redakční	redakční
reference	reference
reflex	reflex
reflexu	reflexu
reformních	reformních
reformou	reformou
reformě	reformě
regenerace	regenerace
region	region
regionech	regionech
regionu	regionu
regiony	regiony
regionální	regionální
regionálního	regionálního
regionů	regionů
registraci	registraci
registrační	registrační
registrovat	registrovat
regulace	regulace
regulačních	regulačních
regulí	regulí
regálu	regálu
reisen	reisen
reitknechtka	reitknechtka
reklama	reklam +a
reklamních	reklamních
reklamním	reklamním
reklamu	reklamu
reklamy	reklam +y
rekonstrukce	rekonstrukce
rekonstrukcích	rekonstrukcích
rekonstruován	rekonstruován
rekrea	rekrea
rekreaci	rekreaci
rekreanty	rekreanty
rekreačních	rekreačních
rekrutují	rekrutují
rektorem	rektorem
rekvalifikaci	rekvalifikaci
relaci	relaci
relací	relací
relativní	relativní
relativně	relativně
relaxačním	relaxačním
reliéfy	reliéfy
renomovaných	renomovaných
rentabilitou	rentabilitou
rentgen	rentgen
rentgenem	rentgenem
rentgenové	rentgenové
rentiérskou	rentiérskou
rentiérské	rentiérské
rentiérských	rentiérských
reorganizace	reorganizace
reorganizací	reorganizací
reparát	reparát
reportér	reportér
reprezentační	reprezentační
reprezentovaná	reprezentovaná
repro	repro
republice	republi +ce
republika	republi +k +a
republiku	republiku
republiky	republi +k +y
resort	resort
resp	resp
respektive	respektive
respektovat	respektovat
restaurace	restaurace
restaurací	restaurací
restauracím	restauracím
restaurátor	restaurátor
restaurátorem	restaurátorem
restaurátorské	restaurátorské
restaurátorskými	restaurátorskými
restaurátorů	restaurátorů
restaurátoři	restaurátoři
restituentů	restituentů
restituovaného	restituovaného
restriktivní	restriktivní
restrukturalizace	restrukturalizace
restrukturalizací	restrukturalizací
resyl	resyl
retušování	retušování
revolucí	revolucí
revoluční	revoluční
rezervovanosti	rezervovanosti
rezervy	rezervy
rezolutními	rezolutními
reálnou	reálnou
reálná	reálná
reálné	reálné
reálném	reálném
reálných	reálných
režii	režii
režim	režim
režimu	režimu
riener	riener
risk	risk
riskantní	riskantní
riskovat	riskovat
riviéra	riviéra
riviéře	riviéře
rizikem	rizikem
riziko	riziko
riziku	riziku
roce	ro +ce
rodila	rodila
rodina	rodin +a
rodinnou	rodinnou
rodinného	rodinného
rodinnému	rodinnému
rodinným	rodinným
rodinu	rodinu
rodiny	rodin +y
rodině	rodině
rodiče	rodiče
rodném	rodném
rodí	rodí
rohy	rohy
roháček	roháček
rokem	rokem
roku	roku
roky	ro +ky
rolbou	rolbou
roli	roli
romantickým	romantickým
románů	románů
room	room
roste	roste
rostlinného	rostlinného
rostlinným	rostlinným
rostou	rostou
rostoucí	rostoucí
roswitha	roswitha
roušku	roušku
roveň	roveň
rovnají	rovnají
rovnosti	rovnosti
rovnováze	rovnováze
rovná	rovná
rovným	rovným
rovněž	rovněž
roxby	roxby
rozborem	rozborem
rozboru	rozboru
rozběhl	rozběhl
rozdíl	rozdíl
rozdílné	rozdílné
rozdílu	rozdílu
rozdíly	rozdíly
rozdělení	rozdělení
rozdělit	rozdělit
rozdělí	rozdělí
rozebrat	rozebrat
rozebrána	rozebrána
rozeznávat	rozeznávat
rozhlas	rozhlas
rozhlase	rozhlase
rozhled	rozhled
rozhodla	rozhodla
rozhodli	rozhodli
rozhodne	rozhodne
rozhodnout	rozhodnout
rozhodnutí	rozhodnutí
rozhodně	rozhodně
rozhodovat	rozhodovat
rozhodování	rozhodování
rozhoduje	rozhoduje
rozhodující	rozhodující
rozhodujících	rozhodujících
rozhodujícím	rozhodujícím
rozhovor	rozhovor
rozhovorech	rozhovorech
rozhovoru	rozhovoru
rozjeli	rozjeli
rozjezd	rozjezd
rozkládá	rozkládá
rozklížené	rozklížené
rozkmitaných	rozkmitaných
rozkradou	rozkradou
rozkřiklo	rozkřiklo
rozlišit	rozlišit
rozloze	rozloze
rozmanitá	rozmanitá
rozmezí	rozmezí
rozmnožit	rozmnožit
rozmyslí	rozmyslí
rozměrech	rozměrech
rozměry	rozměry
rozpad	rozpad
rozpaků	rozpaků
rozplynou	rozplynou
rozpor	rozpor
rozporu	rozporu
rozpočet	rozpočet
rozpočtové	rozpočtové
rozpočtových	rozpočtových
rozpočtu	rozpočtu
rozprodávají	rozprodávají
rozptyl	rozptyl
rozptýleny	rozptýleny
rozptýlení	rozptýlení
rozrůstá	rozrůstá
rozsah	rozsah
rozsahu	rozsahu
rozsáhlá	rozsáhlá
rozsáhlé	rozsáhlé
rozsáhlých	rozsáhlých
roztoky	roztoky
roztrhl	roztrhl
roztrhání	roztrhání
roztříděny	roztříděny
roztříštěnost	roztříštěnost
rozumné	rozumné
rozumný	rozumný
rozumnější	rozumnější
rozumí	rozumí
rozumíte	rozumíte
rozumějte	rozumějte
rozvinout	rozvinout
rozvinutá	rozvinutá
rozvoj	rozvoj
rozvoje	rozvoje
rozvojem	rozvojem
rozvoji	rozvoji
rozvojová	rozvojová
rozvojové	rozvojové
rozvíjejícím	rozvíjejícím
rozvíjeny	rozvíjeny
rozvíjení	rozvíjení
rozčilují	rozčilují
rozčleněna	rozčleněna
rozšiřuje	rozšiřuje
rozšíření	rozšíření
rozšířit	rozšířit
rozšíří	rozšíří
roční	roční
ročních	ročních
ročník	ročník
ročním	ročním
ročně	ročně
rožnov	rožnov
rožnovsko	rožnovsko
rubrice	rubri +ce
rubrika	rubri +k +a
rubriky	rubri +k +y
ruce	ru +ce
ruch	ruch
ruchu	ruchu
ruda	ruda
rudolf	rudolf
rudé	rudé
rukopisu	rukopisu
rukou	ru +kou
rukověť	rukověť
ruku	ruku
ruky	ru +ky
rukách	rukách
ruska	ruska
ruském	ruském
ruční	ruční
ručí	ručí
rušení	rušení
rybářství	rybářství
rybí	rybí
rychle	rychle
rychleji	rychleji
rychlejší	rychlejší
rychlejším	rychlejším
rychlost	rychlost
rychlosti	rychlosti
rychlé	rychlé
rychlém	rychlém
rychlému	rychlému
rychlý	rychlý
rysem	rysem
ráda	ráda
rádce	rádce
rádi	rádi
rádia	rádia
rádio	rádio
rámce	rámce
rámci	rámci
rámec	rámec
rámeček	rámeček
rámečku	rámečku
rámečky	rámečky
rámy	rámy
rána	rána
ráno	ráno
rázem	rázem
rýže	rýže
rčením	rčením
růst	růst
růstem	růstem
růstový	růstový
růstu	růstu
různou	různou
různé	různé
různého	různého
různý	různý
různých	různých
různým	různým
různými	různými
různě	různě
růžice	růžice
růžici	růžici
sada	sad +a
sady	sad +y
saldo	saldo
salima	salima
salon	salon
sama	sam +a
sami	sami
samolepek	samolepek
samolepka	samolepka
samoobsluha	samoobsluha
samoplátci	samoplátci
samosprávy	samosprávy
samostatné	samostatné
samostatném	samostatném
samostatně	samostatně
samostatnější	samostatnější
samotnou	samotnou
samotném	samotném
samotní	samotní
samotných	samotných
samozřejmostí	samozřejmostí
samozřejmá	samozřejmá
samozřejmě	samozřejmě
samoúčelné	samoúčelné
samy	sam +y
samé	samé
samého	samého
sanyo	sanyo
saněmi	saněmi
satelitním	satelitním
sauna	sauna
sazba	sazb +a
sazbami	sazbami
sazbou	sazbou
sazbu	sazbu
sazby	sazb +y
sazeb	sazeb
sbližování	sbližování
sbíhají	sbíhají
sbírek	sbírek
sbírku	sbírku
sběratel	sběratel
sběratele	sběratele
sběratelem	sběratelem
sběrateli	sběrateli
sběratelé	sběratelé
sběratelů	sběratelů
scan	scan
scannery	scannery
schikaneder	schikaneder
schopen	schopen
schopni	schopni
schopno	schopno
schopnost	schopnost
schopnosti	schopnosti
schopností	schopností
schopny	schopny
schopné	schopné
schopní	schopní
schopných	schopných
schvalovací	schvalovací
schvalování	schvalování
schvaluje	schvaluje
schválen	schválen
schváleno	schváleno
schválení	schválení
schválený	schválený
schéma	schéma
schůzek	schůzek
schůzkou	schůzkou
schůzkách	schůzkách
sdružení	sdružení
sdružují	sdružují
sdělení	sdělení
sdělil	sdělil
sdělila	sdělila
sdělovacích	sdělovacích
sděluje	sděluje
sdělujeme	sdělujeme
sebe	sebe
sebedůvěry	sebedůvěry
sebemenší	sebemenší
sebou	sebou
sedm	sedm
sedmdesát	sedmdesát
sedmi	sedmi
sedmileté	sedmileté
seger	seger
sehnat	sehnat
seifertova	seifertova
sektoru	sektoru
sekundy	sekundy
seliko	seliko
selskou	selskou
selském	selském
selský	selský
semináři	semináři
seniorů	seniorů
senovážné	senovážné
senzaci	senzaci
separátní	separátní
sepsána	sepsána
sergas	sergas
serge	serge
serioznost	serioznost
seriozní	seriozní
seriózního	seriózního
service	service
services	services
servis	servis
servisem	servisem
servisní	servisní
servisních	servisních
servisu	servisu
servírovat	servírovat
sestav	sestav
sestavili	sestavili
sestavit	sestavit
sestavování	sestavování
sestra	sestra
sestávají	sestávají
sestává	sestává
setkal	setkal
setkat	setkat
setkání	setkání
setrvání	setrvání
severní	severní
severoamerickém	severoamerickém
severu	severu
sevře	sevře
sexuální	sexuální
seznam	seznam
seznamu	seznamu
seznamuji	seznamuji
seznamy	seznamy
seznámeni	seznámeni
seznámit	seznámit
sezonu	sezonu
sezvat	sezvat
sezónu	sezónu
sezóny	sezóny
sezóně	sezóně
sečetlo	sečetlo
seřizoval	seřizoval
seřizování	seřizování
seřídit	seřídit
seřízení	seřízení
sešel	sešel
sféra	sféra
sféře	sféře
shodneme	shodneme
shopping	shopping
show	show
shrnuto	shrnuto
shánět	shánět
sice	sice
sidon	sidon
sienja	sienja
signatura	signatura
signovaná	signovaná
signálu	signálu
silnic	silnic
silnice	silnice
silnicích	silnicích
silniční	silniční
silničářů	silničářů
silná	silná
silné	silné
silný	silný
silně	silně
situace	situace
situaci	situaci
sjednanou	sjednanou
sjednané	sjednané
sjednat	sjednat
sjednocení	sjednocení
sjednotit	sjednotit
sjednávány	sjednávány
sjezdovek	sjezdovek
sjezdovky	sjezdovky
skalnaté	skalnaté
skandál	skandál
skeptický	skeptický
skla	skla
sklad	sklad
skladba	skladba
skladovací	skladovací
skleniček	skleniček
skleničkou	skleničkou
skleničku	skleničku
sklepů	sklepů
sklonku	sklonku
skloubíte	skloubíte
skluzů	skluzů
skládanku	skládanku
skončily	skončily
skončí	skončí
skoro	skoro
skromnější	skromnější
skrývá	skrývá
skupin	skupin
skupina	skupin +a
skupinami	skupinami
skupinky	skupinky
skupinové	skupinové
skupinových	skupinových
skupinu	skupinu
skupiny	skupin +y
skupinách	skupinách
skupině	skupině
skutečnost	skutečnost
skutečnosti	skutečnosti
skutečností	skutečností
skutečnou	skutečnou
skutečného	skutečného
skutečný	skutečný
skutečným	skutečným
skutečnými	skutečnými
skutečně	skutečně
skutková	skutková
skvost	skvost
skvosty	skvosty
skůtrech	skůtrech
slabikářem	slabikářem
slabá	slabá
slabé	slabé
slabý	slabý
slabší	slabší
slabších	slabších
slad	slad
sladu	sladu
slaný	slaný
slavnostně	slavnostně
slavná	slavná
slavíček	slavíček
slavíčka	slavíčka
sledoval	sledoval
sledovali	sledovali
sledované	sledované
sledovat	sledovat
sledování	sledování
sledujeme	sledujeme
sledují	sledují
slehnout	slehnout
sleva	sleva
slevou	slevou
slezská	slezská
slibovaných	slibovaných
slibují	slibují
sliby	sliby
slogany	slogany
slosování	slosování
sloučeniny	sloučeniny
sloučení	sloučení
sloučit	sloučit
sloužily	sloužily
sloužit	sloužit
slouží	slouží
slova	slov +a
slovem	slovem
slovensko	slovensko
slovenskou	slovenskou
slovensku	slovensku
slovenská	slovenská
slovenské	slovenské
slovenského	slovenského
slovenský	slovenský
slovenských	slovenských
slovenskými	slovenskými
slovinska	slovinska
slovo	slovo
slovy	slov +y
složen	složen
složena	složena
složení	složení
složil	složil
složit	složit
složitostí	složitostí
složitou	složitou
složitá	složitá
složitějším	složitějším
složkou	složkou
složí	složí
slunce	slunce
sluneční	sluneční
slunečníky	slunečníky
slunění	slunění
slušná	slušná
slušné	slušné
slušný	slušný
službou	službou
službu	službu
služby	služby
službách	službách
službám	službám
služeb	služeb
služební	služební
služebních	služebních
služebního	služebního
slyšet	slyšet
slábnoucími	slábnoucími
sláva	sláva
slávu	slávu
slíbil	slíbil
slídilové	slídilové
smetana	smetan +a
smetanovi	smetanovi
smetanu	smetanu
smetany	smetan +y
smlouva	smlouv +a
smlouvu	smlouvu
smlouvy	smlouv +y
smlouvách	smlouvách
smlouvám	smlouvám
smluv	smluv
smluvní	smluvní
smluvního	smluvního
smluvním	smluvním
smolař	smolař
smolné	smolné
smrt	smrt
smrti	smrti
smržovka	smržovka
smutkem	smutkem
smíchově	smíchově
smíšené	smíšené
smíšeným	smíšeným
směnka	směnka
směnkami	směnkami
směnu	směnu
směny	směny
směně	směně
směrech	směrech
směrem	směrem
směrnice	směrnice
směrovány	směrovány
směrových	směrových
směrovým	směrovým
směru	směru
směřovalo	směřovalo
snachu	snachu
snack	snack
snad	snad
snadno	snadno
snadnou	snadnou
snadnému	snadnému
snaha	snah +a
snahu	snahu
snahy	snah +y
snaze	snaze
snažil	snažil
snažit	snažit
snaží	snaží
snažím	snažím
snažíme	snažíme
snižování	snižování
snižováním	snižováním
snižuje	snižuje
snobské	snobské
snídaní	snídaní
snídaně	snídaně
sníh	sníh
snímku	snímku
snížena	snížena
sníženou	sníženou
snížené	snížené
snížení	snížení
snížených	snížených
snížil	snížil
snížila	snížila
snížit	snížit
sníží	sníží
sněhem	sněhem
sněhovou	sněhovou
sněhové	sněhové
sněhu	sněhu
sněžné	sněžné
sněžných	sněžných
sobota	sobota
sobotu	sobotu
sobotách	sobotách
soběslav	soběslav
soch	soch
sochařů	sochařů
socialistického	socialistického
sociologické	sociologické
sociální	sociální
sociálních	sociálních
sociálního	sociálního
sociálním	sociálním
softex	softex
software	software
softwarové	softwarové
sojové	sojové
soju	soju
solarmax	solarmax
solidarity	solidarity
solidet	solidet
solidetu	solidetu
solidnost	solidnost
solidnosti	solidnosti
solidní	solidní
solidního	solidního
solventnosti	solventnosti
somol	somol
sortiment	sortiment
sortimentu	sortimentu
sortimentů	sortimentů
soubor	soubor
souběhu	souběhu
souběžně	souběžně
soucy	soucy
soud	soud
soudci	soudci
soudit	soudit
soudní	soudní
soudních	soudních
soudního	soudního
soudním	soudním
soudně	soudně
soudu	soudu
soudí	soudí
soudím	soudím
soudíte	soudíte
souhlasem	souhlasem
souhlasí	souhlasí
souhrn	souhrn
soukromníka	soukromníka
soukromopodnikatelské	soukromopodnikatelské
soukromá	soukromá
soukromé	soukromé
soukromého	soukromého
soukromí	soukromí
soukromých	soukromých
soukromě	soukromě
souladu	souladu
soupeřem	soupeřem
souprava	souprav +a
soupravy	souprav +y
sourozence	sourozence
sousední	sousední
sousedních	sousedních
sousedé	sousedé
sousedů	sousedů
soustavnou	soustavnou
soustavný	soustavný
soustavným	soustavným
soustavně	soustavně
soustruh	soustruh
soustružník	soustružník
soustátí	soustátí
soustředit	soustředit
soustřeďování	soustřeďování
soutěž	soutěž
soutěže	soutěže
soutěži	soutěži
související	související
souvisejících	souvisejících
souvislosti	souvislosti
souvisí	souvisí
souvztažnosti	souvztažnosti
současnosti	současnosti
současnou	současnou
současná	současná
současné	současné
současném	současném
současný	současný
současným	současným
současně	současně
součást	součást
součástek	součástek
součástkových	součástkových
součástky	součástky
součástkách	součástkách
součástí	součástí
soňa	soňa
spadá	spadá
spalin	spalin
spatří	spatří
special	special
specialisty	specialisty
specialisté	specialisté
specialistů	specialistů
specializace	specializace
specializací	specializací
specializovaná	specializovaná
specializované	specializované
specializovaného	specializovaného
specializovaný	specializovaný
specializovaných	specializovaných
specializovat	specializovat
specializována	specializována
specializuje	specializuje
specifický	specifický
specifických	specifických
specifika	specifika
specifikaci	specifikaci
specifikovaných	specifikovaných
speciál	speciál
speciální	speciální
speciálního	speciálního
speciálními	speciálními
speciálně	speciálně
spedice	spedice
spediční	spediční
spektra	spektra
spektrum	spektrum
spekulací	spekulací
spis	spis
spisovatel	spisovatel
splakat	splakat
splatili	splatili
spletl	spletl
splní	splní
splnění	splnění
splynutí	splynutí
splácet	splácet
splátek	splátek
splátku	splátku
spodní	spodní
spojen	spojen
spojena	spojena
spojeno	spojeno
spojené	spojené
spojení	spojení
spojených	spojených
spojit	spojit
spojové	spojové
spojuje	spojuje
spojů	spojů
spokojeni	spokojeni
spokojenost	spokojenost
spokojenosti	spokojenosti
spokojíte	spokojíte
spol	spol
spolehlivosti	spolehlivosti
spolehlivé	spolehlivé
spolehlivě	spolehlivě
spolehnout	spolehnout
společenskou	společenskou
společenská	společenská
společenské	společenské
společnost	společnost
společnostech	společnostech
společnostem	společnostem
společnosti	společnosti
společností	společností
společnou	společnou
společná	společná
společné	společné
společného	společného
společníci	společníci
společník	společník
společníka	společní +k +a
společníkem	společníkem
společníky	společní +k +y
společníků	společníků
společně	společně
spolu	spolu
spolumajitelé	spolumajitelé
spolumajitelů	spolumajitelů
spolupracovali	spolupracovali
spolupracovat	spolupracovat
spolupracovníci	spolupracovníci
spolupracovník	spolupracovník
spolupracovníky	spolupracovníky
spolupracovníků	spolupracovníků
spolupracuje	spolupracuje
spoluprací	spoluprací
spolupráce	spolupráce
spolupráci	spolupráci
spoluvlastnictví	spoluvlastnictví
spoluvlastníky	spoluvlastníky
spoléhá	spoléhá
sponzora	sponzora
sponzorskou	sponzorskou
spor	spor
sporožirových	sporožirových
sport	sport
sportovní	sportovní
sportovních	sportovních
sportovního	sportovního
sportovním	sportovním
sportování	sportování
sporty	sporty
spotřeba	spotřeb +a
spotřebitel	spotřebitel
spotřebitele	spotřebitele
spotřebitelským	spotřebitelským
spotřebitelů	spotřebitelů
spotřebitelům	spotřebitelům
spotřební	spotřební
spotřebního	spotřebního
spotřebou	spotřebou
spotřeboval	spotřeboval
spotřebu	spotřebu
spotřebujete	spotřebujete
spotřeby	spotřeb +y
spotřebě	spotřebě
spousta	spousta
spoustu	spoustu
spouštěcím	spouštěcím
spočítejte	spočítejte
spočívá	spočívá
spořitelen	spořitelen
spořitelní	spořitelní
spoří	spoří
sppi	sppi
spravedlivě	spravedlivě
spravují	spravují
sprcha	sprcha
sprchou	sprchou
sprchování	sprchování
sprchu	sprchu
sprchuje	sprchuje
sprchujete	sprchujete
springer	springer
správa	správ +a
správce	správ +ce
správky	správ +ky
správně	správně
správy	správ +y
správě	správě
sprše	sprše
spáchání	spáchání
spálené	spálené
spálení	spálení
spínaných	spínaných
spíš	spíš
spíše	spíše
spřeženími	spřeženími
srazit	srazit
srdečnou	srdečnou
srní	srní
srovnat	srovnat
srovnatelná	srovnatelná
srovnatelného	srovnatelného
srovnatelní	srovnatelní
srovnání	srovnání
srovnávali	srovnávali
srovnávat	srovnávat
srovnávání	srovnávání
srovnáváním	srovnáváním
srozumitelně	srozumitelně
srážet	srážet
srážkou	srážkou
sráží	sráží
stabilitě	stabilitě
stabilizaci	stabilizaci
stabilnímu	stabilnímu
stabilnější	stabilnější
stadion	stadion
stadiu	stadiu
stagnuje	stagnuje
stal	stal
stala	stala
stali	stali
standardní	standardní
standardních	standardních
stane	stane
stanice	stanice
stanici	stanici
stanicích	stanicích
stanou	stanou
stanovena	stanoven +a
stanoveny	stanoven +y
stanovená	stanovená
stanovené	stanovené
stanoveného	stanoveného
stanovení	stanovení
stanovených	stanovených
stanovila	stanovila
stanovisko	stanovisko
stanovit	stanovit
stanoví	stanoví
staroměstské	staroměstské
starost	starost
starosta	starosta
starostka	starostka
starostové	starostové
starostů	starostů
starou	starou
starožitnictví	starožitnictví
starožitnostech	starožitnostech
starožitnosti	starožitnosti
starožitnostmi	starožitnostmi
starožitností	starožitností
starožitné	starožitné
starožitníci	starožitníci
starožitník	starožitník
starožitníka	starožitníka
starožitníků	starožitníků
starožitných	starožitných
start	start
staré	staré
starého	starého
starý	starý
starých	starých
starým	starým
starší	starší
starších	starších
statcích	statcích
statek	statek
statické	statické
statistika	statistika
statisíce	statisíce
statisícové	statisícové
statisíců	statisíců
statku	statku
statky	statky
statkář	statkář
stav	stav
stavby	stavby
stavbyvedoucí	stavbyvedoucí
stavbyvedoucích	stavbyvedoucích
staveb	staveb
stavebnictví	stavebnictví
stavebnin	stavebnin
stavební	stavební
stavebních	stavebních
stavebního	stavebního
stavebním	stavebním
stavebně	stavebně
stavidel	stavidel
stavu	stavu
staví	staví
stavěl	stavěl
stačilo	stačilo
stačí	stačí
staška	staška
stech	stech
stefan	stefan
stefana	stefana
stejnopisech	stejnopisech
stejnou	stejnou
stejná	stejná
stejné	stejné
stejného	stejného
stejném	stejném
stejný	stejný
stejných	stejných
stejným	stejným
stejně	stejně
stereotyp	stereotyp
stesky	stesky
stihli	stihli
stimulovat	stimulovat
stimulují	stimulují
stojí	stojí
stokorunovou	stokorunovou
stokrát	stokrát
stole	stole
století	století
stolní	stolní
stolu	stolu
stomatologa	stomatologa
stomatologickou	stomatologickou
stomatologické	stomatologické
stomatologové	stomatologové
stop	stop
stopkami	stopkami
stoprocentně	stoprocentně
stouply	stouply
stoupne	stoupne
stoupá	stoupá
stovek	stovek
stovky	stovky
stočného	stočného
strach	strach
stran	stran
strana	stran +a
stranu	stranu
strany	stran +y
stranách	stranách
straně	straně
strasse	strasse
strasti	strasti
strategickém	strategickém
strategie	strategie
strategii	strategii
strategií	strategií
strava	strav +a
stravné	stravné
stravného	stravného
stravovacích	stravovacích
stravování	stravování
stravy	strav +y
strašecí	strašecí
strašák	strašák
stresu	stresu
strhává	strhává
striktní	striktní
strohé	strohé
stroj	stroj
stroje	stroje
strojírenské	strojírenské
strojírenských	strojírenských
strojírenství	strojírenství
strojů	strojů
stromů	stromů
strop	strop
stropu	stropu
struktura	struktur +a
strukturována	strukturována
struktury	struktur +y
strukturálních	strukturálních
struktuře	struktuře
stručné	stručné
stránce	strán +ce
stránku	stránku
stránky	strán +ky
strávený	strávený
strávil	strávil
student	student
studenti	studenti
studentů	studentů
studentům	studentům
studená	studená
studené	studené
studia	studia
studie	studie
studiem	studiem
studijních	studijních
studiu	studiu
studium	studium
studovaný	studovaný
studovat	studovat
stupeň	stupeň
stupni	stupni
stupních	stupních
stupňů	stupňů
styku	styku
styl	styl
stylová	stylová
stylu	stylu
stál	stál
stála	stála
stále	stále
stálicí	stálicí
stálé	stálé
stálí	stálí
stálých	stálých
stánkař	stánkař
stánku	stánku
stánky	stánky
stánků	stánků
stát	stát
státech	státech
státní	státní
státních	státních
státního	státního
státním	státním
státu	státu
státy	státy
státě	státě
států	států
stávalo	stávalo
stává	stává
stáří	stáří
stáž	stáž
stáže	stáže
stáži	stáži
stínadlech	stínadlech
stírání	stírání
stísněnými	stísněnými
stěhování	stěhování
stěhuje	stěhuje
stěna	stěna
stěžovatelé	stěžovatelé
stěžují	stěžují
středa	středa
střediska	střediska
středisko	středisko
středisku	středisku
střední	střední
středních	středních
středního	středního
středním	středním
středně	středně
středoevropské	středoevropské
středověké	středověké
středověký	středověký
středu	středu
střetu	střetu
střežit	střežit
stříbro	stříbro
stůl	stůl
subdodavatelů	subdodavatelů
subjekty	subjekty
subjektů	subjektů
subsidiární	subsidiární
subvencovat	subvencovat
sugestopedické	sugestopedické
sumu	sumu
sumě	sumě
superkontramultiextraunikátní	superkontramultiextraunikátní
superlativech	superlativech
supermarketu	supermarketu
suvenýry	suvenýry
suverénně	suverénně
sušice	sušice
svalů	svalů
svatba	svatba
svatého	svatého
svatých	svatých
svaz	svaz
svazového	svazového
svazový	svazový
svazů	svazů
svařovaných	svařovaných
svoboda	svoboda
svoje	svoje
svoji	svoji
svojí	svojí
svou	svou
svoz	svoz
svářeče	svářeče
svého	svého
svém	svém
svému	svému
svést	svést
svítí	svítí
svých	svých
svým	svým
svými	svými
svědčí	svědčí
svět	svět
světa	světa
světla	světla
světlo	světlo
světové	světové
světového	světového
světovém	světovém
světě	světě
svěřených	svěřených
svůj	svůj
symbol	symbol
sympatie	sympatie
syna	syna
systematicky	systematicky
systematický	systematický
systém	systém
systémem	systémem
systémové	systémové
systému	systému
systémy	systémy
systémů	systémů
sázek	sázek
sázet	sázet
sázka	sáz +k +a
sázku	sázku
sázky	sáz +k +y
sázkám	sázkám
sídel	sídel
sídla	sídla
sídlem	sídlem
sídlo	sídlo
sídlí	sídlí
sídlící	sídlící
síla	síl +a
sílu	sílu
síly	síl +y
sílící	sílící
sítích	sítích
sítě	sítě
sóji	sóji
sýrů	sýrů
tablety	tablety
tabulka	tabul +k +a
tabulky	tabul +k +y
tachometru	tachometru
tady	tady
tajemství	tajemství
tajné	tajné
tajných	tajných
takovou	takovou
taková	taková
takové	takové
takového	takového
takovém	takovém
takovému	takovému
takový	takový
takových	takových
takovým	takovým
takto	takto
taky	taky
takzvaný	takzvaný
také	také
takže	takže
tamní	tamní
tato	tato
taxa	taxa
taxikáři	taxikáři
taxislužby	taxislužby
taxíka	taxíka
tchajwanskou	tchajwanskou
team	team
technical	technical
technice	techni +ce
technici	technici
technické	technické
technického	technického
technickém	technickém
technických	technických
technik	technik
technika	techni +k +a
technikami	technikami
techniku	techniku
techniky	techni +k +y
techniků	techniků
technologická	technologická
technologické	technologické
technologických	technologických
technologie	technologie
technologii	technologii
tedy	tedy
tehdy	tehdy
telecom	telecom
telefon	telefon
telefonem	telefonem
telefonické	telefonické
telefonizace	telefonizace
telefonní	telefonní
telefonoval	telefonoval
telefony	telefony
telekomunikace	telekomunikace
telekomunikacích	telekomunikacích
telekomunikační	telekomunikační
televize	televize
televizi	televizi
televizní	televizní
televizních	televizních
televizního	televizního
televizor	televizor
telex	telex
temelín	temelín
temném	temném
tempem	tempem
tempery	tempery
tempu	tempu
tempy	tempy
tendence	tendence
tendenci	tendenci
tenisové	tenisové
tento	tento
tenčila	tenčila
teoretické	teoretické
teorie	teorie
tepelnou	tepelnou
tepelné	tepelné
tepla	tepla
teplice	teplice
teplo	teplo
teplotu	teplotu
teploty	teploty
teplá	teplá
teplé	teplé
teplým	teplým
teprve	teprve
terasa	terasa
terinvest	terinvest
terminály	terminály
termín	termín
termínech	termínech
termínu	termínu
termíny	termíny
terénu	terénu
terčík	terčík
terčíkem	terčíkem
test	test
testcomem	testcomem
testovaného	testovaného
testování	testování
testu	testu
testy	testy
testů	testů
text	text
textil	textil
textilní	textilní
textilních	textilních
textilu	textilu
textovému	textovému
teče	teče
therm	therm
thámova	thámova
till	till
time	time
tipnout	tipnout
tipovali	tipovali
tips	tips
tipy	tipy
tiskopisy	tiskopisy
tiskopisů	tiskopisů
tiskovinu	tiskovinu
tisku	tisku
tiskárny	tiskárny
tisíc	tisíc
tisíce	tisíce
tisíci	tisíci
tisícovku	tisícovku
tito	tito
titulek	titulek
titulní	titulní
titulu	titulu
tištěnými	tištěnými
tlakem	tlakem
tlaky	tlaky
tloušťce	tloušťce
tlumočnice	tlumočnice
tohle	tohle
toho	toho
tohoto	tohoto
tokiu	tokiu
tolar	tolar
tolik	tolik
tomto	tomto
tomu	tomu
tomuto	tomuto
tops	tops
topí	topí
torontu	torontu
torzo	torzo
totiž	totiž
toto	toto
totéž	totéž
touto	touto
továrničku	továrničku
továrny	továrny
továrně	továrně
toyota	toyot +a
toyoty	toyot +y
tradice	tradice
tradiční	tradiční
tradičními	tradičními
traduje	traduje
trakt	trakt
tramvajových	tramvajových
tramvají	tramvají
transformace	transformace
transformační	transformační
transformátor	transformátor
transformátoru	transformátoru
transformátorů	transformátorů
translator	translator
transped	transped
transplantační	transplantační
tranzitní	tranzitní
trasu	trasu
tratí	tratí
travel	travel
trefa	trefa
trendu	trendu
trestného	trestného
trestněprávní	trestněprávní
trestu	trestu
trhem	trhem
trhu	trhu
trhy	trhy
trhů	trhů
triky	triky
tripartitu	tripartitu
tripartity	tripartity
tripartitě	tripartitě
triček	triček
trička	trička
tričko	tričko
trochou	trochou
trochu	trochu
troja	troja
trojkový	trojkový
trojnásobek	trojnásobek
tropez	tropez
trpělivost	trpělivost
trsy	trsy
trvale	trvale
trvalo	trvalo
trvalé	trvalé
trvalého	trvalého
trvalými	trvalými
trvá	trvá
trvání	trvání
trzích	trzích
trápí	trápí
trávníček	trávníček
trávící	trávící
tržby	tržby
tržeb	tržeb
tržní	tržní
tržních	tržních
tržního	tržního
tržním	tržním
tržními	tržními
tržně	tržně
tuctem	tuctem
tudíž	tudíž
tuhá	tuhá
tuně	tuně
tupé	tupé
turecko	turecko
turecku	turecku
turecké	turecké
turistickou	turistickou
turistické	turistické
turistického	turistického
turistický	turistický
turistika	turisti +k +a
turistiku	turistiku
turistiky	turisti +k +y
turisty	turisty
turisté	turisté
turistů	turistů
turistům	turistům
turnova	turnova
tuto	tuto
tutovka	tutovka
tutovku	tutovku
tuzemského	tuzemského
tuzemský	tuzemský
tuzemských	tuzemských
tužka	tužka
tvarech	tvarech
tvarovány	tvarovány
tvorbou	tvorbou
tvorbu	tvorbu
tvorby	tvorby
tvorbě	tvorbě
tvořivosti	tvořivosti
tvoří	tvoří
tvrdila	tvrdila
tvrdosti	tvrdosti
tvrdé	tvrdé
tvrdí	tvrdí
tvrdý	tvrdý
tvrdým	tvrdým
tvrdě	tvrdě
tvrzením	tvrzením
tvář	tvář
tvářecí	tvářecí
tváří	tváří
tvůrci	tvůrci
typické	typické
typického	typického
typický	typický
typickým	typickým
typové	typové
typu	typu
typy	typy
typům	typům
tyrolskou	tyrolskou
tyroly	tyroly
tyto	tyto
tytéž	tytéž
tábor	tábor
táhne	táhne
táhnou	táhnou
táži	táži
téhle	téhle
téhož	téhož
témata	témata
tématem	tématem
tématickými	tématickými
tématikou	tématikou
téměř	téměř
této	této
tímto	tímto
týden	týden
týdeníku	týdeníku
týdne	týdne
týdnech	týdnech
týdnem	týdnem
týdny	týdny
týdně	týdně
týkala	týkala
týkat	týkat
týká	týká
týmové	týmové
týna	týna
týnská	týnská
týně	týně
týče	týče
těch	těch
těchto	těchto
těla	těla
těmito	těmito
těmto	těmto
těsná	těsná
těsné	těsné
těstovin	těstovin
těstoviny	těstoviny
těstovinách	těstovinách
těšily	těšily
těší	těší
těžba	těžba
těžiště	těžiště
těžko	těžko
těžkou	těžkou
těžké	těžké
třeba	třeba
třebaže	třebaže
třebová	třebová
třebíč	třebíč
třech	třech
třemi	třemi
třetinu	třetinu
třetiny	třetiny
třetí	třetí
třicet	třicet
třiceti	třiceti
třikrát	třikrát
třídu	třídu
třídy	třídy
třídě	třídě
tříhvězdičkovými	tříhvězdičkovými
tříleté	tříleté
třímilionovou	třímilionovou
třímilionová	třímilionová
třímilionové	třímilionové
třísměnném	třísměnném
ubrat	ubrat
ubytovací	ubytovací
ubytování	ubytování
ubytováním	ubytováním
uchazeči	uchazeči
uchazečů	uchazečů
uchytí	uchytí
ucházet	ucházet
udivilo	udivilo
udivující	udivující
udržet	udržet
udržují	udržují
udál	udál
události	události
udáním	udáním
udílení	udílení
udělal	udělal
udělala	udělal +a
udělali	udělali
udělaly	udělal +y
udělat	udělat
uhel	uhel
uhelné	uhelné
uhradil	uhradil
uhradit	uhradit
ujetých	ujetých
ukazuje	ukazuje
ukazují	ukazují
ukládá	ukládá
ukončeno	ukončeno
ukončení	ukončení
ukončit	ukončit
ukradeno	ukradeno
ukradeny	ukradeny
ukázala	ukázal +a
ukázalo	ukázalo
ukázaly	ukázal +y
ukázat	ukázat
ukáže	ukáže
ulehčit	ulehčit
ulic	ulic
ulice	ulice
ulici	ulici
ulicích	ulicích
ulička	ulička
ullika	ullika
ullmann	ullmann
ullmanna	ullmanna
ullmannův	ullmannův
ullík	ullík
ultrasuperkontramultiextraunikátní	ultrasuperkontramultiextraunikátní
umisťování	umisťování
umocněné	umocněné
umožnila	umožnila
umožnilo	umožnilo
umožnit	umožnit
umožníme	umožníme
umožněn	umožněn
umožněna	umožněna
umožňuje	umožňuje
umožňují	umožňují
umyjete	umyjete
umístili	umístili
umístěn	umístěn
umístěny	umístěny
umístění	umístění
umísťování	umísťování
uměl	uměl
umělce	umělce
umělci	umělci
umělecko	umělecko
uměleckohistorickými	uměleckohistorickými
umělecká	umělecká
umělecké	umělecké
uměleckém	uměleckém
umělecký	umělecký
uměleckých	uměleckých
uměleckými	uměleckými
umění	umění
umět	umět
unaven	unaven
unaveni	unaveni
unie	unie
unikát	unikát
unikátní	unikátní
univerzitního	univerzitního
upevnit	upevnit
upevněná	upevněná
uplatnili	uplatnili
uplatnit	uplatnit
uplatnění	uplatnění
uplatněním	uplatněním
uplatňovat	uplatňovat
uplatňování	uplatňování
uplatňuje	uplatňuje
uplynulé	uplynulé
uplynulém	uplynulém
uplynulých	uplynulých
upomínky	upomínky
upoutat	upoutat
upozornilo	upozornilo
upozornit	upozornit
upozorníme	upozorníme
upozorněn	upozorněn
upozornění	upozornění
upozorňují	upozorňují
upraven	upraven
upravena	upraven +a
upraveno	upraveno
upravenou	upravenou
upraveny	upraven +y
upravených	upravených
upravit	upravit
upravovali	upravovali
upravují	upravují
upravujících	upravujících
upřesnili	upřesnili
upřesní	upřesní
upřesňují	upřesňují
upřímný	upřímný
urychlení	urychlení
urychleně	urychleně
určena	určen +a
určeno	určeno
určenou	určenou
určeny	určen +y
určení	určení
určených	určených
určenými	určenými
určit	určit
určitou	určitou
určité	určité
určitého	určitého
určitém	určitém
určitý	určitý
určitých	určitých
určitě	určitě
určuje	určuje
určí	určí
usilovat	usilovat
usiluje	usiluje
usilují	usilují
uskutečnilo	uskutečnilo
uskutečňoval	uskutečňoval
uslyšíte	uslyšíte
usnadněno	usnadněno
usnadňuje	usnadňuje
usnesení	usnesení
usnesením	usnesením
uspokojení	uspokojení
uspořené	uspořené
uspořit	uspořit
uspořádali	uspořádali
uspořádat	uspořádat
uspořádáním	uspořádáním
uspěje	uspěje
uspět	uspět
ustanovení	ustanovení
ustavili	ustavili
utkání	utkání
utržení	utržení
utěšeně	utěšeně
utřesou	utřesou
uvaleno	uvaleno
uvažovat	uvažovat
uvažování	uvažování
uvažujeme	uvažujeme
uvažujete	uvažujete
uvede	uvede
uveden	uveden
uvedeni	uvedeni
uvedenou	uvedenou
uvedeny	uvedeny
uvedené	uvedené
uvedeného	uvedeného
uvedeném	uvedeném
uvedení	uvedení
uvedením	uvedením
uvedený	uvedený
uvedených	uvedených
uvedl	uvedl
uveřejňujeme	uveřejňujeme
uvidí	uvidí
uvolnila	uvolnila
uvolní	uvolní
uvolněné	uvolněné
uvolnění	uvolnění
uvolňují	uvolňují
uvádí	uvádí
uvádím	uvádím
uvádíme	uvádíme
uvádějí	uvádějí
uváděl	uváděl
uváděných	uváděných
uvést	uvést
uvítací	uvítací
uvítal	uvítal
uvědomili	uvědomili
uvědomit	uvědomit
uvědomuje	uvědomuje
uzavírané	uzavírané
uzavírat	uzavírat
uzavřela	uzavřela
uzavřeli	uzavřeli
uzavřené	uzavřené
uzavření	uzavření
uzavřením	uzavřením
uzavřít	uzavřít
uznání	uznání
uznávanou	uznávanou
učebního	učebního
učilištích	učilištích
učit	učit
učitel	učitel
učitelů	učitelů
učitelům	učitelům
učňovská	učňovská
učňovských	učňovských
učňové	učňové
ušetřit	ušetřit
ušetří	ušetří
ušetříte	ušetříte
uškodit	uškodit
užitečné	užitečné
užitečnější	užitečnější
užitkem	užitkem
užití	užití
uživatel	uživatel
uživatele	uživatele
uživatelském	uživatelském
uživatelům	uživatelům
uživí	uživí
užíval	užíval
užívaná	užívaná
užívat	užívat
užíváním	užíváním
užším	užším
vachulková	vachulková
vada	vad +a
vadama	vadama
vadamu	vadamu
vady	vad +y
vadí	vadí
vajíčka	vajíčka
valašsku	valašsku
valná	valná
valorizaci	valorizaci
valutoví	valutoví
valuty	valuty
valy	valy
vana	van +a
vancouveru	vancouveru
vanová	vanová
vanu	vanu
vany	van +y
vaně	vaně
varech	varech
variabilní	variabilní
variantou	variantou
variantě	variantě
varovat	varovat
varováním	varováním
vars	vars
varsem	varsem
vary	vary
vavřince	vavřince
vazba	vazb +a
vazby	vazb +y
vazbách	vazbách
vaše	vaše
vašeho	vašeho
vašem	vašem
vašimi	vašimi
vaší	vaší
vaším	vaším
vcelku	vcelku
vchodem	vchodem
vchodu	vchodu
vede	vede
vedena	veden +a
vedeny	veden +y
vedená	vedená
vedení	vedení
vedením	vedením
vedl	vedl
vedle	vedle
vedlejší	vedlejší
vedlejšího	vedlejšího
vedoucí	vedoucí
vedoucího	vedoucího
vejce	vejce
vejdovského	vejdovského
veksláci	veksláci
veletrh	veletrh
veletrhu	veletrhu
veletrhy	veletrhy
veletrhů	veletrhů
veletrzích	veletrzích
veletržní	veletržní
velice	velice
velikost	velikost
velikosti	velikosti
velikostí	velikostí
velkolepou	velkolepou
velkoobchod	velkoobchod
velkoobchodní	velkoobchodní
velkoobchodů	velkoobchodů
velkoodběrateli	velkoodběrateli
velkoplošných	velkoplošných
velkorysá	velkorysá
velkou	velkou
velká	velká
velké	velké
velkého	velkého
velkém	velkém
velkému	velkému
velký	velký
velkých	velkých
velkým	velkým
velkými	velkými
velmi	velmi
velvyslanectví	velvyslanectví
venkově	venkově
ventil	ventil
venture	venture
vernisáž	vernisáž
verze	verze
verzi	verzi
vesele	vesele
veselí	veselí
vesměs	vesměs
vesnice	vesnice
vesnici	vesnici
vetešnictví	vetešnictví
veverková	veverková
vezme	vezme
vezmu	vezmu
večer	večer
večera	večera
večerní	večerní
večerních	večerních
večeře	večeře
veřejnost	veřejnost
veřejnosti	veřejnosti
veřejná	veřejná
veřejné	veřejné
veřejného	veřejného
veřejných	veřejných
veškerá	veškerá
veškeré	veškeré
vhodnou	vhodnou
vhodná	vhodná
vhodné	vhodné
vhodný	vhodný
vhodných	vhodných
vhodným	vhodným
vhodně	vhodně
viditelnost	viditelnost
viditelnou	viditelnou
viditelným	viditelným
vidí	vidí
vidím	vidím
vidíme	vidíme
vidíte	vidíte
viděl	viděl
viděli	viděli
viděno	viděno
vidět	vidět
villinger	villinger
vina	vina
vinaři	vinaři
vinařům	vinařům
vinici	vinici
vinná	vinná
vinných	vinných
vinohradech	vinohradech
vinou	vinou
vinu	vinu
vináren	vináren
vinárna	vinárna
visí	visí
vizum	vizum
vkladu	vkladu
vkladů	vkladů
vklouznete	vklouznete
vkládat	vkládat
vkus	vkus
vladislava	vladislava
vlak	vlak
vlakové	vlakové
vlaků	vlaků
vlastimil	vlastimil
vlastnické	vlastnické
vlastnického	vlastnického
vlastnický	vlastnický
vlastnických	vlastnických
vlastnictví	vlastnictví
vlastnictvím	vlastnictvím
vlastnili	vlastnili
vlastnosti	vlastnosti
vlastností	vlastností
vlastní	vlastní
vlastních	vlastních
vlastníci	vlastníci
vlastního	vlastního
vlastník	vlastník
vlastníka	vlastní +k +a
vlastníky	vlastní +k +y
vlastníků	vlastníků
vlastníkům	vlastníkům
vlastním	vlastním
vlastnímu	vlastnímu
vlastně	vlastně
vlasů	vlasů
vliv	vliv
vlivy	vlivy
vlivů	vlivů
vlna	vln +a
vlnou	vlnou
vlnu	vlnu
vlny	vln +y
vlně	vlně
vloni	vloni
vločkami	vločkami
vložených	vložených
vložil	vložil
vložit	vložit
vloží	vloží
vltavou	vltavou
vltavského	vltavského
vláda	vlád +a
vládne	vládne
vládní	vládní
vlády	vlád +y
vládě	vládě
vnese	vnese
vnitra	vnitra
vnitřní	vnitřní
vnitřních	vnitřních
vnitřního	vnitřního
vnuky	vnuky
vnášejí	vnášejí
vnést	vnést
voda	vod +a
vodku	vodku
vodní	vodní
vodochody	vodochody
vodoměr	vodoměr
vodoměru	vodoměru
vodoměry	vodoměry
vodoměrů	vodoměrů
vody	vod +y
vodítko	vodítko
vojáci	vojáci
volba	volba
volbou	volbou
volbu	volbu
volbě	volbě
volného	volného
volný	volný
volně	volně
volnější	volnější
volání	volání
vostatek	vostatek
vozidel	vozidel
vozidla	vozidla
vozily	vozily
vozu	vozu
vozy	vozy
vozů	vozů
vpašování	vpašování
vraceli	vraceli
vrací	vrací
vraťme	vraťme
vrcholného	vrcholného
vrcholového	vrcholového
vrcholu	vrcholu
vrozenými	vrozenými
vrstev	vrstev
vrstevníky	vrstevníky
vrstva	vrstv +a
vrstvy	vrstv +y
vrácení	vrácení
vrátit	vrátit
vrátí	vrátí
vršovice	vršovice
vsadila	vsadila
vsadit	vsadit
vstoupily	vstoupily
vstoupit	vstoupit
vstup	vstup
vstupné	vstupné
vstupních	vstupních
vstupu	vstupu
vstupuje	vstupuje
vstupují	vstupují
vstupující	vstupující
vstupů	vstupů
vstříc	vstříc
vtěleny	vtěleny
vybavena	vybavena
vybaveni	vybaveni
vybavení	vybavení
vybavený	vybavený
vybavených	vybavených
vybavit	vybavit
vyber	vyber
vybereme	vybereme
vyberou	vyberou
vybočují	vybočují
vybrané	vybrané
vybraných	vybraných
vybrat	vybrat
vybrán	vybrán
vybrána	vybrána
vybudoval	vybudoval
vybudováním	vybudováním
vybíráme	vybíráme
vycházejí	vycházejí
vycházející	vycházející
vycházela	vycházel +a
vycházely	vycházel +y
vycházet	vycházet
vychází	vychází
vycítila	vycítila
vydala	vydala
vydalo	vydalo
vydaná	vydaná
vydané	vydané
vydat	vydat
vydavatel	vydavatel
vydavatele	vydavatele
vydavatelství	vydavatelství
vydavatelů	vydavatelů
vydražené	vydražené
vydraží	vydraží
vydržely	vydržely
vydrží	vydrží
vydá	vydá
vydáno	vydáno
vydány	vydány
vydání	vydání
vydáním	vydáním
vydávají	vydávají
vydávané	vydávané
vydávat	vydávat
vydává	vydává
vydáváni	vydáváni
vydávání	vydávání
vydírání	vydírání
vydělají	vydělají
vydělal	vydělal
vydělat	vydělat
vydělá	vydělá
vydělávají	vydělávají
vyhazují	vyhazují
vyhlazování	vyhlazování
vyhledávat	vyhledávat
vyhledávání	vyhledávání
vyhlásil	vyhlásil
vyhlášen	vyhlášen
vyhlášeni	vyhlášeni
vyhláškami	vyhláškami
vyhlédnutým	vyhlédnutým
vyhnal	vyhnal
vyhnout	vyhnout
vyhnula	vyhnula
vyhodit	vyhodit
vyhodnocen	vyhodnocen
vyhodnocené	vyhodnocené
vyhodnocení	vyhodnocení
vyhovoval	vyhovoval
vyhovovala	vyhovoval +a
vyhovovaly	vyhovoval +y
vyhovovat	vyhovovat
vyhovuje	vyhovuje
vyhoví	vyhoví
vyhověla	vyhověla
vyhraněnému	vyhraněnému
vyhrál	vyhrál
vyhrát	vyhrát
vyjde	vyjde
vyjely	vyjely
vyjma	vyjma
vyjmenovaných	vyjmenovaných
vyjádřeny	vyjádřeny
vyjádření	vyjádření
vyjádřením	vyjádřením
vyjádřil	vyjádřil
vyjádřit	vyjádřit
vyjádřitelná	vyjádřitelná
vyjímáme	vyjímáme
vyjít	vyjít
vyjíždějí	vyjíždějí
vyklubat	vyklubat
vyklízení	vyklízení
vykonávat	vykonávat
vykonávání	vykonávání
vykoupali	vykoupali
vykoupat	vykoupat
vykradli	vykradli
vykupuje	vykupuje
vylehávání	vylehávání
vylepšení	vylepšení
vylepšovat	vylepšovat
vyloupit	vyloupit
vyloučeno	vyloučeno
vyloučit	vyloučit
vyloženě	vyloženě
vylučují	vylučují
vymezení	vymezení
vymáhal	vymáhal
vymáhání	vymáhání
vyměnit	vyměnit
vyměnitelnými	vyměnitelnými
vyměňovat	vyměňovat
vyměřovací	vyměřovací
vyměřovacího	vyměřovacího
vynakládá	vynakládá
vynaložené	vynaložené
vynechat	vynechat
vynikající	vynikající
vynikajícím	vynikajícím
vynutí	vynutí
vyobrazení	vyobrazení
vypadají	vypadají
vypadalo	vypadalo
vypadá	vypadá
vyplacení	vyplacení
vyplatily	vyplatily
vyplatit	vyplatit
vyplatí	vyplatí
vyplnily	vyplnily
vyplnit	vyplnit
vyplněnou	vyplněnou
vyplynulo	vyplynulo
vyplácejí	vyplácejí
vyplácet	vyplácet
vyplácí	vyplácí
vyplývají	vyplývají
vyplývající	vyplývající
vyplývá	vyplývá
vyplňovat	vyplňovat
vypnut	vypnut
vypouštění	vypouštění
vypovídaly	vypovídaly
vypovídat	vypovídat
vypověditelné	vypověditelné
vypověděli	vypověděli
vypovědět	vypovědět
vypočte	vypočte
vypočtené	vypočtené
vypočítá	vypočítá
vypočítávat	vypočítávat
vypočítává	vypočítává
vypořádání	vypořádání
vypracovat	vypracovat
vypravuje	vypravuje
vyprodány	vyprodány
vyprání	vyprání
vyprávěla	vyprávěla
vypršel	vypršel
vyptávání	vyptávání
vypůjčit	vypůjčit
vyrobeno	vyrobeno
vyrobeném	vyrobeném
vyrobených	vyrobených
vyroste	vyroste
vyrostl	vyrostl
vyrovnat	vyrovnat
vyrovnání	vyrovnání
vyrábí	vyrábí
vyrábějícího	vyrábějícího
vyrábějícím	vyrábějícím
vyráběny	vyráběny
vyráběných	vyráběných
vyrábět	vyrábět
vysazeno	vysazeno
vyskytují	vyskytují
vysloveně	vysloveně
vysokoškolské	vysokoškolské
vysokoškolský	vysokoškolský
vysoká	vysoká
vysoké	vysoké
vysoký	vysoký
vysokých	vysokých
vysokým	vysokým
vysokými	vysokými
vyspělé	vyspělé
vyspělých	vyspělých
vyspělými	vyspělými
vystaven	vystaven
vystavené	vystavené
vystaveného	vystaveného
vystavovat	vystavovat
vystavovatelů	vystavovatelů
vystavuje	vystavuje
vystihnout	vystihnout
vystudovat	vystudovat
vystupovali	vystupovali
vystupovat	vystupovat
vystupování	vystupování
vystupuje	vystupuje
vystřídalo	vystřídalo
vysvětlit	vysvětlit
vysvětluje	vysvětluje
vysvětlují	vysvětlují
vysíláme	vysíláme
vysílány	vysílány
vytiskne	vytiskne
vytlačit	vytlačit
vytočte	vytočte
vytvořena	vytvořen +a
vytvořeny	vytvořen +y
vytvořeného	vytvořeného
vytvoření	vytvoření
vytvořil	vytvořil
vytvořila	vytvořila
vytvořit	vytvořit
vytvoří	vytvoří
vytvářet	vytvářet
vytváří	vytváří
vyučen	vyučen
vyučení	vyučení
vyučených	vyučených
využil	využil
využili	využili
využit	využit
využití	využití
využitím	využitím
využít	využít
využívaným	využívaným
využívat	využívat
využívá	využívá
využívání	využívání
vyvedeném	vyvedeném
vyvezeno	vyvezeno
vyvezeny	vyvezeny
vyvléknout	vyvléknout
vyvolal	vyvolal
vyvolala	vyvolal +a
vyvolaly	vyvolal +y
vyvolané	vyvolané
vyvolat	vyvolat
vyvolá	vyvolá
vyvolávací	vyvolávací
vyvážet	vyvážet
vyvézt	vyvézt
vyvíjet	vyvíjet
vyvěsila	vyvěsila
vyzkoušené	vyzkoušené
vyzkoušení	vyzkoušení
vyzkoušený	vyzkoušený
vyzkoušených	vyzkoušených
vyzkoušet	vyzkoušet
vyznačují	vyznačují
vyznání	vyznání
vyznívá	vyznívá
vyzvednout	vyzvednout
vyzvědět	vyzvědět
vyzývat	vyzývat
vyústily	vyústily
vyústit	vyústit
vyúčtování	vyúčtování
vyčerpání	vyčerpání
vyčerpávajícím	vyčerpávajícím
vyčištění	vyčištění
vyčleněny	vyčleněny
vyčleněných	vyčleněných
vyřešila	vyřešila
vyřešili	vyřešili
vyřídil	vyřídil
vyřídit	vyřídit
vyšetřenou	vyšetřenou
vyšetření	vyšetření
vyšetřit	vyšetřit
vyšetřování	vyšetřování
vyšla	vyšla
vyšplhala	vyšplhala
vyšroubovali	vyšroubovali
vyšší	vyšší
vyššího	vyššího
vyššími	vyššími
vyžadovat	vyžadovat
vyžaduje	vyžaduje
vyžádaly	vyžádaly
vyžádá	vyžádá
vyžádání	vyžádání
vzal	vzal
vzbudil	vzbudil
vzdychat	vzdychat
vzdálenost	vzdálenost
vzdáleny	vzdáleny
vzdělanost	vzdělanost
vzdělání	vzdělání
vzdělávací	vzdělávací
vzestupu	vzestupu
vzhledem	vzhledem
vznik	vznik
vznikajících	vznikajících
vznikl	vznikl
vznikla	vznikla
vzniklá	vzniklá
vzniknou	vzniknou
vzniknout	vzniknout
vzniku	vzniku
vzniká	vzniká
vzorek	vzorek
vzorků	vzorků
vzorný	vzorný
vzorový	vzorový
vzory	vzory
vzpomínané	vzpomínané
vzrostl	vzrostl
vzrostla	vzrostl +a
vzrostly	vzrostl +y
vzrušených	vzrušených
vzrůstající	vzrůstající
vzrůstá	vzrůstá
vztah	vztah
vztahovala	vztahovala
vztahu	vztahu
vztahuje	vztahuje
vztahující	vztahující
vztahy	vztahy
vztahů	vztahů
vzácné	vzácné
vzájemnou	vzájemnou
vzájemná	vzájemná
vzájemné	vzájemné
vzájemného	vzájemného
vzájemný	vzájemný
vzít	vzít
vácha	vácha
václav	václav
václavské	václavské
váhají	váhají
váhat	váhat
váhu	váhu
válce	vál +ce
válec	válec
válkou	vál +kou
vámi	vámi
vápna	vápna
vázalo	vázalo
vázán	vázán
vázáni	vázáni
vážných	vážných
vážně	vážně
vést	vést
vévodí	vévodí
více	více
vícedenními	vícedenními
vídně	vídně
víkend	víkend
víme	víme
vína	vína
vínem	vínem
víte	víte
vítr	vítr
vítáme	vítáme
vítěze	vítěze
vítězem	vítězem
vítězslav	vítězslav
vítězům	vítězům
víře	víře
výborný	výborný
výběr	výběr
výběrem	výběrem
výběrová	výběrová
výběrovém	výběrovém
výběru	výběru
východní	východní
východním	východním
východoevropských	východoevropských
výchozí	výchozí
výcvik	výcvik
výdaj	výdaj
výdaje	výdaje
výdělek	výdělek
výdělečně	výdělečně
výdělkem	výdělkem
výdělku	výdělku
výdělky	výdělky
výdělků	výdělků
výherci	výherci
výherců	výherců
výherní	výherní
výhoda	výhod +a
výhodná	výhodná
výhodné	výhodné
výhodného	výhodného
výhodný	výhodný
výhodně	výhodně
výhodnější	výhodnější
výhodnějšími	výhodnějšími
výhodu	výhodu
výhody	výhod +y
výhodách	výhodách
výhonky	výhonky
výhra	výhr +a
výhradní	výhradní
výhradně	výhradně
výhrou	výhrou
výhru	výhru
výhry	výhr +y
výjimek	výjimek
výjimečné	výjimečné
výjimečně	výjimečně
výjimka	výjim +k +a
výjimkou	výjim +kou
výjimky	výjim +k +y
výkon	výkon
výkonem	výkonem
výkonnost	výkonnost
výkonných	výkonných
výkonným	výkonným
výkonových	výkonových
výkonu	výkonu
výkony	výkony
výkonů	výkonů
výkup	výkup
výkyvy	výkyvy
výletů	výletů
výlučným	výlučným
výlučně	výlučně
výměna	výměna
výměnu	výměnu
výměně	výměně
výnos	výnos
výnosnosti	výnosnosti
výnosný	výnosný
výnosu	výnosu
výpadek	výpadek
výpis	výpis
výplat	výplat
výplaty	výplaty
výpovědní	výpovědní
výpověď	výpověď
výpočet	výpočet
výpočetní	výpočetní
výpočty	výpočty
výrazem	výrazem
výrazné	výrazné
výrazného	výrazného
výrazný	výrazný
výrazně	výrazně
výraznější	výraznější
výroba	výrob +a
výrobce	výrob +ce
výrobci	výrobci
výrobcích	výrobcích
výrobců	výrobců
výrobek	výrobek
výrobkem	výrobkem
výrobkový	výrobkový
výrobku	výrobku
výrobky	výrob +ky
výrobků	výrobků
výrobní	výrobní
výrobních	výrobních
výrobního	výrobního
výrobním	výrobním
výrobou	výrobou
výrobu	výrobu
výroby	výrob +y
výrobě	výrobě
výročí	výročí
výsledcích	výsledcích
výsledek	výsledek
výsledkem	výsledkem
výsledku	výsledku
výsledky	výsledky
výsledků	výsledků
výsledkům	výsledkům
výsledného	výsledného
výslovně	výslovně
výstav	výstav
výstava	výstav +a
výstavba	výstavb +a
výstavbou	výstavbou
výstavby	výstavb +y
výstavbě	výstavbě
výstaviště	výstaviště
výstavní	výstavní
výstavních	výstavních
výstavu	výstavu
výstavy	výstav +y
výstavě	výstavě
výstrahu	výstrahu
výstroj	výstroj
výstupech	výstupech
výstupních	výstupních
výtahů	výtahů
výtisků	výtisků
výtvarného	výtvarného
výtvarníkem	výtvarníkem
výuce	výu +ce
výuka	výu +ka
výukou	výu +kou
výukových	výukových
výuku	výuku
vývoj	vývoj
vývoje	vývoje
vývoji	vývoji
vývojové	vývojové
vývojovými	vývojovými
vývojáři	vývojáři
vývoz	vývoz
vývozce	vývozce
vývozní	vývozní
vývozu	vývozu
vývěsní	vývěsní
výzkumného	výzkumného
výzkumy	výzkumy
význam	význam
významnou	významnou
významná	významná
významné	významné
významný	významný
významným	významným
významnější	významnější
výzvu	výzvu
výčtu	výčtu
výšce	výšce
výše	výše
výši	výši
výškových	výškových
výživy	výživy
včas	včas
včetně	včetně
věcem	věcem
věci	věci
věcí	věcí
vědomí	vědomí
vědí	vědí
věděl	věděl
vědět	vědět
vějička	vějička
věkového	věkového
věkovými	věkovými
věkově	věkově
věku	věku
věnovala	věnoval +a
věnovaly	věnoval +y
věnovanou	věnovanou
věnovat	věnovat
věnována	věnována
věnuje	věnuje
věnují	věnují
věnující	věnující
věra	věra
věrným	věrným
věrnými	věrnými
věrohodně	věrohodně
většina	většin +a
většinou	většinou
většiny	většin +y
většině	většině
větší	větší
větších	větších
většího	většího
větším	větším
věřitel	věřitel
věřitele	věřitele
věřiteli	věřiteli
věřte	věřte
věříme	věříme
věšelo	věšelo
však	však
všech	všech
všechna	všechn +a
všechno	všechno
všechny	všechn +y
všední	všední
všedním	všedním
všeho	všeho
všem	všem
všemi	všemi
všeobecná	všeobecná
všeobecné	všeobecné
všeobecného	všeobecného
všeobecném	všeobecném
všeobecně	všeobecně
všeodpovědna	všeodpovědna
všichni	všichni
všimnou	všimnou
všimněte	všimněte
vštěpuji	vštěpuji
všude	všude
všudypřítomná	všudypřítomná
všímat	všímat
vůbec	vůbec
vůle	vůle
vůli	vůli
vůní	vůní
vůně	vůně
vůči	vůči
vždy	vždy
vždycky	vždycky
vždyť	vždyť
wacker	wacker
wackerova	wackerova
wade	wade
waldhauser	waldhauser
washingtonova	washingtonova
whitney	whitney
wilt	wilt
windows	windows
winter	winter
xeroxových	xeroxových
zabezpečení	zabezpečení
zabezpečili	zabezpečili
zabraňují	zabraňují
zabránili	zabránili
zabírá	zabírá
zabývající	zabývající
zabývajících	zabývajících
zabývajícího	zabývajícího
zabývalo	zabývalo
zabývat	zabývat
zabývá	zabývá
zabýváme	zabýváme
zaběhlému	zaběhlému
zachař	zachař
zachovat	zachovat
zachránit	zachránit
zachytil	zachytil
zachytit	zachytit
zacházení	zacházení
zadarmo	zadarmo
zadavatelů	zadavatelů
zadlužení	zadlužení
zadání	zadání
zadává	zadává
zahrada	zahrad +a
zahrady	zahrad +y
zahraniční	zahraniční
zahraničních	zahraničních
zahraničního	zahraničního
zahraničním	zahraničním
zahraničními	zahraničními
zahraničí	zahraničí
zahrnout	zahrnout
zahrnuje	zahrnuje
zahrnul	zahrnul
zahájení	zahájení
zahájením	zahájením
zahájila	zahájila
zahájit	zahájit
zahájí	zahájí
zahřeje	zahřeje
zainteresované	zainteresované
zainteresovaným	zainteresovaným
zainteresováni	zainteresováni
zajistila	zajistila
zajistit	zajistit
zajistí	zajistí
zajištění	zajištění
zajištěním	zajištěním
zajišťovala	zajišťovala
zajišťována	zajišťována
zajišťování	zajišťování
zajišťuje	zajišťuje
zajišťují	zajišťují
zajišťující	zajišťující
zajkr	zajkr
zajímal	zajímal
zajímalo	zajímalo
zajímat	zajímat
zajímavost	zajímavost
zajímavé	zajímavé
zajímavého	zajímavého
zajímavých	zajímavých
zajímavější	zajímavější
zajímá	zajímá
zakazují	zakazují
zakladatel	zakladatel
zakládání	zakládání
zakotvena	zakotvena
zakotvuje	zakotvuje
zakoupené	zakoupené
zakoupeného	zakoupeného
zakoupila	zakoupila
zakoupit	zakoupit
zakázané	zakázané
zakázek	zakázek
zakázkami	zakázkami
zakázkové	zakázkové
zakázku	zakázku
zakázky	zakázky
zakázkách	zakázkách
založena	založena
založené	založené
založení	založení
založil	založil
založila	založila
založili	založili
založit	založit
zamezení	zamezení
zamyslet	zamyslet
zamítnuta	zamítnuta
zaměstnance	zaměstnance
zaměstnancem	zaměstnancem
zaměstnanci	zaměstnanci
zaměstnanců	zaměstnanců
zaměstnancům	zaměstnancům
zaměstnanec	zaměstnanec
zaměstnaneckých	zaměstnaneckých
zaměstnanost	zaměstnanost
zaměstnanosti	zaměstnanosti
zaměstnaných	zaměstnaných
zaměstnavatel	zaměstnavatel
zaměstnavatele	zaměstnavatele
zaměstnavatelem	zaměstnavatelem
zaměstnavatelských	zaměstnavatelských
zaměstnavatelé	zaměstnavatelé
zaměstnání	zaměstnání
zaměstnává	zaměstnává
zaměstnáváme	zaměstnáváme
zaměřen	zaměřen
zaměřena	zaměřena
zaměření	zaměření
zaměřením	zaměřením
zaměřených	zaměřených
zaměřil	zaměřil
zaměřila	zaměřila
zaměřit	zaměřit
zaměřovala	zaměřovala
zaměřuje	zaměřuje
zaměří	zaměří
zanedbatelná	zanedbatelná
zanedbatelné	zanedbatelné
zanikne	zanikne
zaostal	zaostal
zaostalé	zaostalé
zapadá	zapadá
zaplacené	zaplacené
zaplaceného	zaplaceného
zaplacení	zaplacení
zaplatila	zaplatila
zaplatili	zaplatili
zaplatit	zaplatit
zaplatí	zaplatí
zaplatíte	zaplatíte
zaplavila	zaplavila
zapojení	zapojení
zapojí	zapojí
zapomenutý	zapomenutý
zapomněli	zapomněli
zapotřebí	zapotřebí
započten	započten
započtení	započtení
započítat	započítat
započítává	započítává
zapříčiněné	zapříčiněné
zapůjčit	zapůjčit
zaregistrovat	zaregistrovat
zaručen	zaručen
zaručena	zaručena
zaručenou	zaručenou
zaručeně	zaručeně
zaručit	zaručit
zase	zase
zasedli	zasedli
zaskočím	zaskočím
zaslané	zaslané
zaslat	zaslat
zaslechnete	zaslechnete
zaslána	zaslána
zastaralá	zastaralá
zastaven	zastaven
zastavení	zastavení
zastavit	zastavit
zastaví	zastaví
zastavíte	zastavíte
zastoupení	zastoupení
zastoupit	zastoupit
zastupuji	zastupuji
zastánce	zastánce
zastávané	zastávané
zastávek	zastávek
zastřešení	zastřešení
zastřešený	zastřešený
zasypal	zasypal
zasypaný	zasypaný
zasílán	zasílán
zatají	zatají
zatoulání	zatoulání
zatoužili	zatoužili
zatratí	zatratí
zatím	zatím
zatímco	zatímco
zatížena	zatížena
zatíženi	zatíženi
zatížení	zatížení
zatěžuje	zatěžuje
zaujímala	zaujímala
zaujímá	zaujímá
zauzlují	zauzlují
zavalen	zavalen
zavazadel	zavazadel
zavazovat	zavazovat
zavazuje	zavazuje
zaveden	zaveden
zavedenou	zavedenou
zavedení	zavedení
zavedením	zavedením
zavolejte	zavolejte
zavádí	zavádí
zaváděcí	zaváděcí
zavádění	zavádění
zavádět	zavádět
zaváželi	zaváželi
zavážet	zavážet
zavést	zavést
zavřel	zavřel
zavřeno	zavřeno
zaznamenala	zaznamenala
zaznamenán	zaznamenán
zaznamenání	zaznamenání
zazněl	zazněl
začal	začal
začala	začal +a
začali	začali
začalo	začalo
začaly	začal +y
začne	začne
začátek	začátek
začátkem	začátkem
začátku	začátku
začínají	začínají
začínajících	začínajících
začínajícího	začínajícího
začínal	začínal
začínala	začínala
začínali	začínali
začíná	začíná
začínáme	začínáme
začít	začít
zařadilo	zařadilo
zařazen	zařazen
zařazena	zařazen +a
zařazeno	zařazeno
zařazeny	zařazen +y
zařazené	zařazené
zařazení	zařazení
zařazený	zařazený
zařazovaných	zařazovaných
zařízena	zařízena
zařízení	zařízení
zařízeních	zařízeních
zařízením	zařízením
zaškolení	zaškolení
zašlete	zašlete
zašli	zašli
zažitý	zažitý
zbavili	zbavili
zbavit	zbavit
zbavuje	zbavuje
zbohatnout	zbohatnout
zbohatnutí	zbohatnutí
zboží	zboží
zbožím	zbožím
zbraněmi	zbraněmi
zbylo	zbylo
zbylých	zbylých
zbytek	zbytek
zbytečné	zbytečné
zbytečně	zbytečně
zbytkovým	zbytkovým
zbytků	zbytků
zbývající	zbývající
zbývajících	zbývajících
zcela	zcela
zchladne	zchladne
zdaleka	zdaleka
zdanění	zdanění
zdarma	zdarma
zdaňovacím	zdaňovacím
zdaňování	zdaňování
zdech	zdech
zdejších	zdejších
zdeněk	zdeněk
zdevalvované	zdevalvované
zdobený	zdobený
zdobí	zdobí
zdokonaleny	zdokonaleny
zdomácní	zdomácní
zdravotnické	zdravotnické
zdravotnických	zdravotnických
zdravotnictví	zdravotnictví
zdravotní	zdravotní
zdravotního	zdravotního
zdravotníky	zdravotníky
zdravotním	zdravotním
zdravotně	zdravotně
zdravá	zdravá
zdravé	zdravé
zdravého	zdravého
zdraví	zdraví
zdražilo	zdražilo
zdražování	zdražování
zdroj	zdroj
zdroje	zdroje
zdrojem	zdrojem
zdroji	zdroji
zdrojových	zdrojových
zdrojů	zdrojů
zdrženlivější	zdrženlivější
zdvojnásobily	zdvojnásobily
zdvořilý	zdvořilý
zdálo	zdálo
zdánlivě	zdánlivě
zdůraznil	zdůraznil
zdůraznit	zdůraznit
zdůrazněno	zdůrazněno
zdůrazňují	zdůrazňují
zdůvodňuje	zdůvodňuje
zedníka	zedníka
zefektivňují	zefektivňují
zejména	zejména
zeleninou	zeleninou
zeleniny	zeleniny
zeleně	zeleně
zelináři	zelináři
zeman	zeman
zemana	zemana
zemi	zemi
zemské	zemské
zemí	zemí
zemích	zemích
země	země
zemědělce	zemědělce
zemědělci	zemědělci
zemědělskou	zemědělskou
zemědělské	zemědělské
zemědělského	zemědělského
zemědělskými	zemědělskými
zemědělství	zemědělství
zemřel	zemřel
zeptal	zeptal
zeptali	zeptali
zeptá	zeptá
zesnulé	zesnulé
zetě	zetě
zhodnocen	zhodnocen
zhodnocení	zhodnocení
zhodnocuje	zhodnocuje
zhodnoťte	zhodnoťte
zhoršení	zhoršení
zhotovování	zhotovování
zhruba	zhruba
zhýčkané	zhýčkané
zikovsky	zikovsky
zima	zima
zimní	zimní
zimních	zimních
zimou	zimou
zimě	zimě
zisk	zisk
ziskové	ziskové
zisku	zisku
zisky	zisky
zjednodušení	zjednodušení
zjednodušením	zjednodušením
zjednodušeně	zjednodušeně
zjednodušili	zjednodušili
zjednodušit	zjednodušit
zjednodušují	zjednodušují
zjistil	zjistil
zjistila	zjistila
zjistili	zjistili
zjistit	zjistit
zjistíme	zjistíme
zjištěni	zjištěni
zjišťoval	zjišťoval
zjišťujeme	zjišťujeme
zkombinují	zkombinují
zkoumá	zkoumá
zkoušek	zkoušek
zkoušeného	zkoušeného
zkoušku	zkoušku
zkoušky	zkoušky
zkouškách	zkouškách
zkouškám	zkouškám
zkrachoval	zkrachoval
zkracovat	zkracovat
zkrácena	zkrácena
zkrácení	zkrácení
zkrátila	zkrátila
zkrátit	zkrátit
zkrátka	zkrátka
zkrátí	zkrátí
zkrášlení	zkrášlení
zkusit	zkusit
zkusí	zkusí
zkušebna	zkušebn +a
zkušebnictví	zkušebnictví
zkušebnu	zkušebnu
zkušebny	zkušebn +y
zkušební	zkušební
zkušebního	zkušebního
zkušebně	zkušebně
zkušenost	zkušenost
zkušenostech	zkušenostech
zkušenosti	zkušenosti
zkušeností	zkušeností
zkušený	zkušený
zlatá	zlatá
zlaté	zlaté
zlatém	zlatém
zlatých	zlatých
zlepšení	zlepšení
zlepšila	zlepšila
zlepšit	zlepšit
zlepšovací	zlepšovací
zlepšovatelském	zlepšovatelském
zlepšování	zlepšování
zlepšováním	zlepšováním
zlepšuje	zlepšuje
zlepšují	zlepšují
zloděj	zloděj
zloděje	zloděje
zlodějem	zlodějem
zloději	zloději
zlodějů	zlodějů
zlozvyky	zlozvyky
zlíně	zlíně
zmirňován	zmirňován
zmizel	zmizel
zmizelo	zmizelo
zmizely	zmizely
zmizí	zmizí
zmodernizuje	zmodernizuje
zmínila	zmínila
zmínku	zmínku
zmíněn	zmíněn
zmíněnou	zmíněnou
zmíněnému	zmíněnému
zmírní	zmírní
zmýlit	zmýlit
změn	změn
změna	změn +a
změnami	změnami
změnil	změnil
změnila	změnila
změnit	změnit
změnou	změnou
změnu	změnu
změny	změn +y
změnám	změnám
změně	změně
znají	znají
znala	znala
znalce	znalce
znalci	znalci
znalců	znalců
znalec	znalec
znaleckých	znaleckých
znaleckým	znaleckým
znalost	znalost
znalosti	znalosti
znalostmi	znalostmi
znalostí	znalostí
znalého	znalého
znalí	znalí
znamenají	znamenají
znamenalo	znamenalo
znamenat	znamenat
znamená	znamená
znamení	znamení
značkou	znač +kou
značku	značku
značky	znač +ky
značná	značná
značné	značné
značného	značného
značný	značný
značným	značným
značně	značně
zneužití	zneužití
znojemsku	znojemsku
znovu	znovu
znám	znám
známe	známe
známo	známo
známostmi	známostmi
známy	známy
známá	známá
známý	známý
známých	známých
známým	známým
znát	znát
znáte	znáte
zněl	zněl
znění	znění
zodpovídají	zodpovídají
zodpovídat	zodpovídat
zodpovědný	zodpovědný
zodpovědět	zodpovědět
zodpovězené	zodpovězené
zorganizovaný	zorganizovaný
zpeněžit	zpeněžit
zpevnění	zpevnění
zpomalením	zpomalením
zpomalila	zpomalila
zpověď	zpověď
zpozdit	zpozdit
zpočátku	zpočátku
zpožděním	zpožděním
zpracovaná	zpracovaná
zpracované	zpracované
zpracovatelé	zpracovatelé
zpracování	zpracování
zpravidla	zpravidla
zprivatizovaných	zprivatizovaných
zprivatizování	zprivatizování
zprostředkovaně	zprostředkovaně
zprostředkování	zprostředkování
zprostředkovává	zprostředkovává
zpráv	zpráv
zprávy	zprávy
zpět	zpět
zpětně	zpětně
zpěváků	zpěváků
zpřístupnění	zpřístupnění
způsob	způsob
způsobem	způsobem
způsobený	způsobený
způsobila	způsobila
způsobovaly	způsobovaly
způsobu	způsobu
způsobuje	způsobuje
způsobují	způsobují
způsoby	způsoby
zralé	zralé
zredukovat	zredukovat
zrekonstruovat	zrekonstruovat
zrestaurovaný	zrestaurovaný
zrovna	zrovna
zruinuje	zruinuje
zrušen	zrušen
zrušena	zrušen +a
zrušeno	zrušeno
zrušeny	zrušen +y
zrušení	zrušení
zrušili	zrušili
zrychlené	zrychlené
zrychlením	zrychlením
zrychleným	zrychleným
zrychlila	zrychlila
ztlumí	ztlumí
ztratil	ztratil
ztratila	ztratila
ztrácely	ztrácely
ztrácí	ztrácí
ztráta	ztrát +a
ztrátové	ztrátové
ztrátu	ztrátu
ztráty	ztrát +y
ztvárnění	ztvárnění
zubařském	zubařském
zubní	zubní
zuzanky	zuzanky
zvanou	zvanou
zvané	zvané
zvaného	zvaného
zvaných	zvaných
zvažovali	zvažovali
zvažovat	zvažovat
zvedly	zvedly
zvedněte	zvedněte
zvedá	zvedá
zveřejněné	zveřejněné
zveřejnění	zveřejnění
zvládli	zvládli
zvládnou	zvládnou
zvládnout	zvládnout
zvláštní	zvláštní
zvláštním	zvláštním
zvláště	zvláště
zvlášť	zvlášť
zvolil	zvolil
zvolila	zvolila
zvolit	zvolit
zvrátit	zvrátit
zvuk	zvuk
zvuku	zvuku
zvyklostí	zvyklostí
zvyklá	zvyklá
zvyklý	zvyklý
zvyšovat	zvyšovat
zvyšování	zvyšování
zvyšuje	zvyšuje
zvyšují	zvyšují
zvyšující	zvyšující
zvážení	zvážení
zvážit	zvážit
zvídavější	zvídavější
zvířátek	zvířátek
zvýhodní	zvýhodní
zvýhodněn	zvýhodněn
zvýhodněny	zvýhodněny
zvýhodněné	zvýhodněné
zvýhodňovat	zvýhodňovat
zvýhodňující	zvýhodňující
zvýraznění	zvýraznění
zvýšené	zvýšené
zvýšení	zvýšení
zvýšením	zvýšením
zvýšil	zvýšil
zvýšila	zvýšil +a
zvýšily	zvýšil +y
zvýšit	zvýšit
zábava	zábava
záchytná	záchytná
záclony	záclony
zádrhel	zádrhel
záhlaví	záhlaví
záhy	záhy
zájem	zájem
zájemce	zájemce
zájemci	zájemci
zájemců	zájemců
zájemcům	zájemcům
zájezdu	zájezdu
zájezdy	zájezdy
zájezdů	zájezdů
zájmem	zájmem
zájmu	zájmu
zákaznici	zákaznici
zákazníci	zákazníci
zákazník	zákazník
zákazníka	zákazní +k +a
zákazníkem	zákazníkem
zákazníkovi	zákazníkovi
zákazníky	zákazní +k +y
zákazníků	zákazníků
zákazníkům	zákazníkům
základ	základ
základem	základem
základna	základna
základní	základní
základních	základních
základního	základního
základním	základním
základu	základu
základy	základy
základě	základě
základů	základů
zákon	zákon
zákona	zákon +a
zákonech	zákonech
zákonem	zákonem
zákonného	zákonného
zákonných	zákonných
zákonodárné	zákonodárné
zákonu	zákonu
zákony	zákon +y
zákoník	zákoník
zákoníku	zákoníku
zákoně	zákoně
zákonů	zákonů
zákrok	zákrok
záležitost	záležitost
záleží	záleží
zálivu	zálivu
záloh	záloh
záloha	záloh +a
zálohami	zálohami
zálohu	zálohu
zálohy	záloh +y
zámcích	zámcích
záminkou	záminkou
zámkovou	zámkovou
zámková	zámková
zámků	zámků
záměr	záměr
záměrně	záměrně
záměry	záměry
záměrů	záměrů
západ	západ
západní	západní
západních	západních
západními	západními
západně	západně
západě	západě
zápornou	zápornou
záporné	záporné
záporný	záporný
zápotoční	zápotoční
zároveň	zároveň
záruka	záru +k +a
zárukou	záru +kou
záruky	záru +k +y
záruční	záruční
záručním	záručním
zásad	zásad
zásada	zásad +a
zásadní	zásadní
zásadních	zásadních
zásadnější	zásadnější
zásadou	zásadou
zásadu	zásadu
zásady	zásad +y
zásadě	zásadě
zásahy	zásahy
zásilce	zásil +ce
zásilek	zásilek
zásilka	zásil +k +a
zásilkového	zásilkového
zásilkových	zásilkových
zásilkovým	zásilkovým
zásilkovými	zásilkovými
zásilku	zásilku
zásilky	zásil +k +y
zásluhou	zásluhou
zásluhy	zásluhy
zásob	zásob
zásobuji	zásobuji
zásoby	zásoby
zástupce	zástupce
zástupci	zástupci
zástupců	zástupců
zástupcům	zástupcům
zátah	zátah
zátiší	zátiší
zátylku	zátylku
zátěž	zátěž
závazcích	závazcích
závazku	závazku
závazky	závazky
závazků	závazků
závazných	závazných
závažnost	závažnost
závažné	závažné
závislá	závislá
závisí	závisí
závod	závod
závodního	závodního
závodním	závodním
závodu	závodu
závody	závody
závodě	závodě
závodů	závodů
závěr	závěr
závěrem	závěrem
závěrečnou	závěrečnou
závěrečné	závěrečné
závěru	závěru
závěsné	závěsné
zázemím	zázemím
záznamní	záznamní
záznamník	záznamník
záznamu	záznamu
zázrak	zázrak
záření	záření
zářivek	zářivek
získají	získají
získal	získal
získala	získala
získali	získali
získané	získané
získat	získat
získá	získá
získám	získám
získání	získání
získáte	získáte
získávají	získávají
získávat	získávat
získáváme	získáváme
získávání	získávání
získáváním	získáváním
zítra	zítra
zóně	zóně
zúčastnit	zúčastnit
zúčastněných	zúčastněných
zúží	zúží
zčásti	zčásti
zřejmé	zřejmé
zřejmě	zřejmě
zřizovací	zřizovací
zříci	zříci
zřídí	zřídí
zřízení	zřízení
zůstala	zůstala
zůstane	zůstane
zůstanou	zůstanou
zůstatek	zůstatek
zůstatku	zůstatku
zůstávají	zůstávají
zůstává	zůstává
úbytku	úbytku
údaje	údaje
údajů	údajů
údolí	údolí
úhledné	úhledné
úhradu	úhradu
úhrady	úhrady
úhradám	úhradám
úhrnná	úhrnná
úklidu	úklidu
úkol	úkol
úkolem	úkolem
úkolu	úkolu
úkoly	úkoly
úkolů	úkolů
úkony	úkony
úkryt	úkryt
úlev	úlev
úmyslu	úmyslu
úměrná	úměrná
úměrně	úměrně
úměry	úměry
únava	únava
úniku	úniku
únms	únms
únmz	únmz
únor	únor
února	února
únoru	únoru
úpadku	úpadku
úpatí	úpatí
úplatek	úplatek
úplnost	úplnost
úplné	úplné
úplný	úplný
úplným	úplným
úplně	úplně
úprav	úprav
úprava	úprav +a
úpravy	úprav +y
úraz	úraz
úrazové	úrazové
úrazového	úrazového
úrazovém	úrazovém
úrazově	úrazově
úrazu	úrazu
úrodnou	úrodnou
úrokové	úrokové
úrokových	úrokových
úroky	úroky
úroků	úroků
úroveň	úroveň
úrovni	úrovni
úrovní	úrovní
úrovně	úrovně
úseku	úseku
úspor	úspor
úspora	úspor +a
úsporného	úsporného
úsporných	úsporných
úsporu	úsporu
úspory	úspor +y
úsporám	úsporám
úspěch	úspěch
úspěchu	úspěchu
úspěchy	úspěchy
úspěšnost	úspěšnost
úspěšnosti	úspěšnosti
úspěšné	úspěšné
úspěšného	úspěšného
úspěšní	úspěšní
úspěšný	úspěšný
úspěšně	úspěšně
úspěších	úspěších
ústav	ústav
ústavní	ústavní
ústavu	ústavu
ústup	ústup
ústí	ústí
ústředí	ústředí
úterky	úterky
úterý	úterý
útlum	útlum
útlumu	útlumu
útok	útok
útokem	útokem
útočí	útočí
útvaru	útvaru
úvahu	úvahu
úvalno	úvalno
úvaze	úvaze
úvěr	úvěr
úvěrovat	úvěrovat
úvěrování	úvěrování
úvěrové	úvěrové
úvěrových	úvěrových
úvěrovými	úvěrovými
úvěru	úvěru
úvěry	úvěry
úvěrů	úvěrů
úzce	úzce
území	území
úzké	úzké
účast	účast
účasti	účasti
účastní	účastní
účastníků	účastníků
účastí	účastí
účelem	účelem
účelově	účelově
účely	účely
účet	účet
účetnictví	účetnictví
účetnictvím	účetnictvím
účetní	účetní
účetního	účetního
účinky	účinky
účinnost	účinnost
účinností	účinností
účinná	účinná
účinné	účinné
účinný	účinný
účinně	účinně
účinnější	účinnější
účtovat	účtovat
účtování	účtování
účtu	účtu
účtuje	účtuje
účtuji	účtuji
účtů	účtů
úřad	úřad
úřadech	úřadech
úřadu	úřadu
úřady	úřady
úřadě	úřadě
úřadům	úřadům
úřednice	úřednice
úředníků	úředníků
úředně	úředně
čase	čase
časem	časem
časopis	časopis
časopisech	časopisech
časopisem	časopisem
časových	časových
často	často
častý	častý
častým	častým
častěji	častěji
častějšímu	častějšímu
času	času
časy	časy
časů	časů
čech	čech
čechami	čechami
čechy	čechy
čedok	čedok
čeho	čeho
čekají	čekají
čekající	čekající
čekat	čekat
čeká	čeká
čekáme	čekáme
čele	čele
čelit	čelit
čelákovice	čelákovice
čemž	čemž
čermáka	čermáka
černobílá	černobílá
černovice	černovice
černá	černá
černé	černé
černého	černého
červeného	červeného
června	června
červnu	červnu
červotočem	červotočem
česko	česko
českomoravské	českomoravské
českomoravského	českomoravského
československo	československo
československé	československé
československého	československého
československým	československým
českou	českou
česká	česká
české	české
českého	českého
českém	českém
českému	českému
český	český
českých	českých
českým	českým
českými	českými
četné	četné
čezem	čezem
češtiny	češtiny
češtině	češtině
čili	čili
čilý	čilý
činila	činila
činili	činili
činnost	činnost
činnostech	činnostech
činnostem	činnostem
činnosti	činnosti
činností	činností
činnou	činnou
činná	činná
činu	činu
činí	činí
činžovních	činžovních
čistá	čistá
čisté	čisté
čistý	čistý
čistých	čistých
čištění	čištění
člen	člen
členem	členem
členové	členové
členy	členy
členů	členů
členům	členům
človíček	človíček
člověk	člověk
člověka	člověka
článek	článek
článku	článku
čokolády	čokolády
čouhá	čouhá
čsfr	čsfr
čtenář	čtenář
čtenářce	čtenář +ce
čtenáře	čtenáře
čtenáři	čtenáři
čtenářka	čtenář +k +a
čtenářku	čtenářku
čtenářky	čtenář +k +y
čtenářů	čtenářů
čtení	čtení
čtete	čtete
čtrnáct	čtrnáct
čtrnáctiletých	čtrnáctiletých
čtvrtek	čtvrtek
čtvrtinu	čtvrtinu
čtvrtletního	čtvrtletního
čtvrtletně	čtvrtletně
čtvrtletí	čtvrtletí
čtyř	čtyř
čtyřech	čtyřech
čtyři	čtyři
čtyřikrát	čtyřikrát
čtyřmi	čtyřmi
čtyřprocentní	čtyřprocentní
čtyřsemestrové	čtyřsemestrové
čtyřčlenná	čtyřčlenná
čtyřčlenné	čtyřčlenné
čtěte	čtěte
čárové	čárové
část	část
částce	část +ce
částech	částech
částečně	částečně
části	části
částka	část +k +a
částkou	část +kou
částku	částku
částky	část +k +y
částí	částí
čísel	čísel
čísla	čísla
čísle	čísle
číslicově	číslicově
číslo	číslo
číšníci	číšníci
řada	řad +a
řadoví	řadoví
řadu	řadu
řady	řad +y
řadí	řadí
řadě	řadě
řazeny	řazeny
řecka	řecka
řecko	řecko
řecká	řecká
ředhošť	ředhošť
ředitel	ředitel
ředitele	ředitele
ředitelem	ředitelem
řediteli	řediteli
ředitelka	ředitelka
ředitelů	ředitelů
řekl	řekl
řekla	řekla
řekli	řekli
řekne	řekne
řekneme	řekneme
řeky	řeky
řemeslné	řemeslné
řetězu	řetězu
řezací	řezací
řečeno	řečeno
řešení	řešení
řešením	řešením
řešit	řešit
řešitelný	řešitelný
řeší	řeší
řidič	řidič
řidiči	řidiči
řidší	řidší
řádcích	řádcích
řádem	řádem
řádného	řádného
řádově	řádově
řádu	řádu
řádí	řádí
řásnovka	řásnovka
říci	říci
říct	říct
řídit	řídit
řídí	řídí
řídící	řídící
řídících	řídících
řídícího	řídícího
října	října
říká	říká
řízené	řízené
řízení	řízení
šachtách	šachtách
šafránu	šafránu
šaldová	šaldová
šampony	šampony
šance	šance
šanci	šanci
šancích	šancích
šedesáti	šedesáti
šedé	šedé
šeků	šeků
šerák	šerák
šest	šest
šesti	šesti
šetření	šetření
šetřit	šetřit
šetří	šetří
ševce	ševce
ševcovské	ševcovské
ševců	ševců
šidí	šidí
šikanování	šikanování
šikovnosti	šikovnosti
šikovných	šikovných
šilinků	šilinků
široká	široká
široké	široké
širokého	širokého
široký	široký
širší	širší
širšímu	širšímu
šití	šití
šizením	šizením
škarka	škarka
škoda	škod +a
škodlivé	škodlivé
škodlivě	škodlivě
škodou	škodou
škody	škod +y
škodě	škodě
škol	škol
škola	škol +a
škole	škole
školení	školení
školením	školením
školicího	školicího
školicím	školicím
školit	školit
školitelem	školitelem
školní	školní
školního	školního
školství	školství
školu	školu
školy	škol +y
školám	školám
škvorci	škvorci
škála	škála
šlofík	šlofík
šlofíka	šlofíka
šmorn	šmorn
šoky	šoky
španělsku	španělsku
španělská	španělská
španělské	španělské
španělského	španělského
španělských	španělských
špatnou	špatnou
špatná	špatná
špatné	špatné
špatný	špatný
špatně	špatně
šperkem	šperkem
šperku	šperku
šperků	šperků
špion	špion
špionem	špionem
špionáž	špionáž
špionáže	špionáže
špionů	špionů
špičce	špičce
špiček	špiček
špičková	špičková
špičkové	špičkové
špičkovém	špičkovém
špičku	špičku
šplhají	šplhají
špála	špála
štoček	štoček
štít	štít
štítkem	štítkem
štěstí	štěstí
štětí	štětí
šulc	šulc
šumava	šumava
šumavská	šumavská
šumavského	šumavského
šumperk	šumperk
šumperka	šumperka
šumperku	šumperku
šuplíku	šuplíku
šupů	šupů
švabinský	švabinský
švadlenková	švadlenková
švech	švech
švédského	švédského
švýcarské	švýcarské
šéfa	šéfa
šéfovi	šéfovi
šéfům	šéfům
šíři	šíři
šňůry	šňůry
šťastného	šťastného
žadatel	žadatel
žadatelů	žadatelů
žaloba	žaloba
žalobu	žalobu
žaluzie	žaluzie
žehlírna	žehlírna
železná	železná
železářských	železářských
ženy	ženy
žere	žere
žhavili	žhavili
žije	žije
živičných	živičných
živnostenského	živnostenského
živnostenský	živnostenský
živnostníky	živnostníky
živností	živností
život	život
života	života
životaschopnost	životaschopnost
životní	životní
životního	životního
životu	životu
žižkov	žižkov
žižkovské	žižkovské
žižkově	žižkově
žvýkačky	žvýkačky
žádaný	žádaný
žádnou	žádnou
žádná	žádná
žádné	žádné
žádném	žádném
žádnému	žádnému
žádný	žádný
žádosti	žádosti
žádostí	žádostí
žádoucí	žádoucí
žádány	žádány
žáka	žáka
žáků	žáků
žánrů	žánrů
žárovkám	žárovkám

