automobilk	automobilek_automobilk_
odborník	odborníc_odborník_
přihlášek	přihlášek_přihlášk_
zákazník	zákazníc_zákazník_
otázk	otázek_otázk_
odborníc	odborníc_odborník_
zákazníc	zákazníc_zákazník_
látk	látek_látk_
položek	položek_položk_
přečk	přeček_přečk_
otázek	otázek_otázk_
zakázek	zakázek_zakázk_
památk	památek_památk_
položk	položek_položk_
vlastník	vlastníc_vlastník_
výjimek	výjimek_výjimk_
nabídk	nabídek_nabídk_
společníc	společníc_společník_
podmínk	podmínek_podmínk_
mark	marek_mark_
společník	společníc_společník_
látek	látek_látk_
zásilek	zásilek_zásilk_
přestávk	přestávek_přestávk_
tričk	triček_tričk_
půjček	půjček_půjčk_
hygienic	hygienic_hygienik_
přeček	přeček_přečk_
hygienik	hygienic_hygienik_
dodávek	dodávek_dodávk_
starožitníc	starožitníc_starožitník_
slavíčk	slavíček_slavíčk_
podmínek	podmínek_podmínk_
hudeček	hudeček_hudečk_
výrobc	výrobc_výrobk_
pracovník	pracovníc_pracovník_
sázk	sázek_sázk_
sázek	sázek_sázk_
vlastníc	vlastníc_vlastník_
slavíček	slavíček_slavíčk_
marek	marek_mark_
nabídek	nabídek_nabídk_
výrobk	výrobc_výrobk_
triček	triček_tričk_
zakázk	zakázek_zakázk_
technic	technic_technik_
přestávek	přestávek_přestávk_
samolepk	samolepek_samolepk_
přihlášk	přihlášek_přihlášk_
obchodník	obchodníc_obchodník_
hudečk	hudeček_hudečk_
pracovníc	pracovníc_pracovník_
půjčk	půjček_půjčk_
technik	technic_technik_
dodávk	dodávek_dodávk_
samolepek	samolepek_samolepk_
obchodníc	obchodníc_obchodník_
nájemník	nájemníc_nájemník_
starožitník	starožitníc_starožitník_
automobilek	automobilek_automobilk_
zásilk	zásilek_zásilk_
nájemníc	nájemníc_nájemník_
výjimk	výjimek_výjimk_
památek	památek_památk_
